ich	I
sie	she, they
die	the; which
sein	be; his
du	you
nicht	not
und	and
es	it
was	what, which
wir	we
er	he
zu	to; too
ein	a; one
in	in
mit	with
wie	how; as
ja	yes
auf	on; up
so	so, such; so
aber	but
hier	here
für	for
von	from, of
haben	have
dass	that
wenn	when, if
an	at, on
da	there; since
nein	no
noch	yet; nor
nur	only
ihr	her, you, their
wissen	know
sich	oneself
aus	from, of
können	can
gut	well; good
auch	also
schon	already
jetzt	now
mal	times
dann	then
meinen	think, mean
als	when, than, as
um	around; (in order) to
mein	my
doch	but; yes
werden	will; become
kein	no
nach	to, after
all	all
man	you, one
oder	or
nichts	nothing
wo	where
wollen	want
gehen	go
mehr	more
warum	why
bitte	please
etwas	something; some
bei	at, with
müssen	must
los	wrong; loose
immer	always
vor	in front of, before; ago
wieder	again
sehr	very
sehen	see
sagen	tell
also	so
wer	who
denn	because
machen	make
dies	this
kommen	come
danken	thank
tun	do
geben	give
nie	never
über	over
sollen	should
vielleicht	perhaps
Weg	way, road; away
dein	your
Leben	life
viel	a lot (of)
wirklich	really; real
heute	today
ganz	quite; full
Zeit	time
bis	to; until
einfach	simple; simply
zurück	back
nun	now
weil	because
damit	so (that); with it
na	well
zwei	two
hallo	hello
sicher	sure; safely
morgen	morning; tomorrow
ab	from
Leid	sorrow
lassen	let
Geld	money
lieb	dear
Tag	day
genau	exactly; exact
(he)raus	out
durch	by; through
schön	beautiful; beautifully
wohl	well, probably
klar	clear; clearly
glauben	believe
her	here
okay	okay
Nacht	night
ohne	without
Liebe	love
unser	our
jemand	someone
reden	talk
gerade	just; straight
ob	whether
hören	hear
mögen	like, may
dort	there
anderer	another
selbst	self; even
denken	think
paar	a couple (of)
weiter	further
Herr	Mister
Ordnung	order
passieren	happen
lange	a long time
gar	at all
hin	there; broken (coll)
gleich	same, immediately
Freund	friend, boyfriend
seit	since
Welt	world
Haus	house
natürlich	of course; natural
Abend	evening
drei	three
recht	right; law; quite (coll)
richtig	right
finden	find
wieso	why
bleiben	stay
tot	dead
unter	under
jung	young
essen	eat; food
davon	of it
nehmen	take
helfen	help
schnell	fast
warten	wait
wegen	because of
stimmen	be correct, vote
dafür	for that
dürfen	be allowed to
genug	enough
sonst	otherwise
Scheiße	shit
halt	stop
zusammen	together
gegen	against
Jahr	year
erst	first, only
stehen	stand
verdammt	damn
bringen	bring
niemand	nobody
brauchen	need
fragen	ask
wann	when
heißen	be called
sprechen	speak
jeder	every(body)
sofort	immediately
fertig	finished, ready
kennen	know
einmal	once
Sohn	son
halten	keep, hold
dabei	with it; there
Kind	child
allein	alone; only
bevor	before
Musik	music
WAHR	true, real
Kopf	head
Sache	thing
gern	gladly
enden	end
spät	late
vergessen	forget
(he)runter	down
fahren	drive
Name	name
dank	thanks to
eins	one
daran	about that
dazu	to that
egal	(all) the same
weit	far
sterben	die
Minute	minute
verstehen	understand
Hilfe	help
beide	both
bald	soon
klein	small
Baby	baby
Glück	luck, happiness
verrückt	crazy; crazily
ruhig	quiet; quietly
darüber	about it
Tür	door
Wasser	water
Auto	car
eigentlich	actually; actual
euer	your
Ruhe	silence
töten	kill
vorbei	by; over
Krieg	war
je	ever, each
darauf	on that
letzter	last
lang	long
bisschen	(a) little
hoch	high
fast	almost
schauen	look
sogar	even
spielen	play
hinter	behind
Ding	thing
Mama	mom
bekommen	get
oben	above
bereit	ready
d(a)rin	in it
neu	new; newly
woher	from where
Wagen	car; dare
arbeiten	work
etwa	about
echt	real; really
Geschichte	history, story
treffen	meet, hit
toll	great
draußen	outside, out
fünf	five
Zimmer	room
Job	job
nett	nice; nicely
groß	large
anders	differently
sorgen	care, worry
welcher	which
einzig	only
Art	type
liegen	lie
verloren	lost
vier	four
alt	old
Kerl	guy
gestern	yesterday
wenig	few, little
bestimmt	certainly; certain
kurz	short; shortly
überhaupt	at all
darum	that is why; around that
Schwester	sister, nurse
schwer	hard, heavy; hard
suchen	look for
zeigen	show; appear
Film	movie
schlecht	bad; poorly
deshalb	that's why
holen	get
hoffen	hope
Bett	bed
Seite	page, site
gefallen	like; favor; pleasure
eben	just; even
Stunde	hour
Herz	heart
wohin	where
trinken	drink
Mensch	human, person
unten	below
Gesicht	face
versuchen	try
Fall	case, fall
verlassen	leave; abandoned
endlich	finally; finite
schlafen	sleep
ziemlich	quite; considerable
manchmal	sometimes
Fest	celebration; firm; firmly
wiedersehen	see again
laufen	run, walk
zwischen	between
niemals	never
während	during; while
Idee	idea
Nummer	number
sondern	but
frei	free; freely
oft	often
Entschuldigung	apology, sorry
ernst	serious; seriously
Schule	school
erzählen	tell
einiger	some
bloß	only; mere
entschuldigen	excuse
setzen	set; sit
bedeuten	mean
Feuer	fire
passen	fit, match
Schuld	fault, debt
d(a)rauf	on it
Platz	place
Papa	dad
Spaß	fun
wichtig	important
Blut	blood
hierher	here
reichen	be enough, reach
glücklich	happy; happily
kaum	hardly
zuerst	at first
stellen	put, stand
falls	if, in case
früh	early
sechs	six
Freundin	girlfriend, friend
lieben	love
Teil	part
langsam	slowly; slow
scheinen	seem, shine
früher	earlier; former
Telefon	phone
Himmel	sky
lernen	learn
zehn	ten
willkommen	welcome
Luft	air, breath
Licht	light
Menge	amount
voll	full
überall	everywhere
Erde	earth
rufen	call
möglich	possible
Eltern	parents
außer	except; without
nah	close
ziehen	pull
Mädchen	girl
wahrscheinlich	probably; likely
nennen	call
FALSCH	wrong; incorrectly
ehrlich	honest; honestly
irgendwas	something
heiraten	marry
Stück	piece
Doktor	doctor
Kaffee	coffee
krank	sick
danach	then, after
Arzt	doctor
schaffen	create, accomplish
völlig	completely; complete
weh	sore, hurt
drüben	over there
Büro	office
irgendwie	somehow
eigen	own
Problem	problem
Wert	value
buchen	book
kaufen	buy
erinnern	remind; remember
direkt	directly; direct
trotzdem	nevertheless
schreiben	write
still	quiet; quietly
Körper	body
retten	save
solcher	such
sitzen	sit
leider	unfortunately
Typ	type
Schlüssel	key
tragen	wear, carry
zwar	though
bereits	already
leicht	easy; easily
Schiff	ship
verlieren	lose
Vater	father
klingen	sound
irgendwo	somewhere
planen	plan
verschwinden	disappear
interessieren	interest
kämpfen	fight
Party	party
hinten	in the back
Kumpel	mate (coll)
General	general
böse	angry, evil
Liebling	darling
acht	eight
froh	glad
hart	hard
vorsichtig	carefully; careful
Zeug	stuff
damals	then
lesen	read
Mist	shit, manure
Zug	train
Geschäft	business, shop
aufhören	stop
Klasse	class
Boss	boss
erklären	explain
fliegen	fly
Laden	shop; load
stolz	proud; proudly
stark	strong; strongly
hassen	hate
fort	away
genauso	equally
Mai	May
besonders	especially
weiß	white
Ärger	trouble
fühlen	feel
Verzeihung	sorry, forgiveness
schicken	send
erwarten	expect
Nachricht	message, news
funktionieren	work, operate
wovon	about what
Gefängnis	prison
Krankenhaus	hospital
umbringen	kill
total	total; totally
vorstellen	imagine, introduce
Sinn	sense, meaning
ändern	change
heraus	out
tanzen	dance
lachen	laugh
nachdem	after
Arm	arm, poor
fallen	fall
wenigstens	at least
geschehen	happen
folgen	follow
eher	rather
dumm	stupid; stupidly
deswegen	that's why
solange	as long as; while
lustig	funny
unmöglich	impossible; not possibly
Bild	picture
führen	lead, guide
unglaublich	incredibly; incredible
Vertrauen	trust
verletzen	hurt
cool	cool
meist	usually, mostly
vorher	before
plötzlich	suddenly; sudden
anrufen	call
Bewegung	movement
kümmern	take care of
(da)rüber	over there; about it
komisch	funny
super	great
sieben	seven
Augenblick	moment
herum	around, about
kalt	cold
wunderbar	wonderful; wonderfully
großartig	great; superbly
Auge	eye
Tisch	table
rum	about; rum
Antwort	answer
schlimm	bad; badly
verheiraten	marry
Wort	word
Vorsicht	caution, care
bezahlen	pay
links	(to the) left
nochmal	again (coll)
Armee	army
bitten	ask
Finger	finger
zahlen	pay
Sicherheit	safety
verkaufen	sell
wozu	why; to which
müde	tired; tiredly
Seele	soul
schießen	shoot
Sonne	sun
selber	oneself
reisen	travel
Team	team
sobald	as soon as
meistern	master
Anfang	beginning
fangen	catch
außerdem	also
Sex	sex
Reise	journey
laut	loud; loudly; according to
Grund	reason
klappen	work (out)
Amerika	America
gefährlich	dangerous; dangerously
gewinnen	win
obwohl	although
Monat	month
behalten	keep
legen	put, lie down
Präsident	president
rechts	(to the) right
anfangen	start
Schluss	end
hübsch	pretty
versprechen	promise
Chef	boss
perfekt	perfect; perfectly
schlagen	beat, hit
tatsächlich	actually; actual
dagegen	however; against this
erfahren	learn; experienced
Mord	murder
Nähe	vicinity
nötig	necessary
offen	open; openly
wach	awake
singen	sing
Beispiel	example
sowieso	anyway
jedenfalls	anyhow
Schwein	pig, pork (coll)
zielen	aim
verdienen	deserve, earn
Geist	spirit, mind, ghost
schreien	scream
Anwalt	lawyer
Show	show
Heim	home
ehren	honor, dignify
unterwegs	on the way, away
reich	rich, empire
Wunder	miracle
Opfer	victim
bekannt	known
hauen	cut, hit
weder	neither
Rücken	back, move
jemals	ever
Partner	partner
Gefahr	danger
Regel	rule
absolut	absolute; absolutely
tief	deep
Befehl	command, order
geschickt	skilled
Wette	bet
gebären	give birth to
Kraft	force; by virtue
Bar	bar; cash
Richtung	direction
Professor	professor
stecken	plug, put
ständig	constantly; constant
erwischen	catch
schrecklich	terrible; terribly
Weise	way; wise
Frieden	peace, tranquility
verliebt	in love; fondly
ehe	before, marriage
dahin	there
wofür	for what
dauern	last
neben	next; next to
Raum	room
benutzen	use
Regierung	government
fernsehen	watch TV; TV
Karte	map, card
Hunger	hunger
diesmal	this time
Preis	price, award
Geschenk	present
hoffentlich	hopefully
manch	some
ansehen	look (at)
Lage	location
wünschen	wish
fehlen	lack
Willen	(for) sake, will
Bescheid	decision, notification
heiß	hot; hotly
Bulle	bull; cop (coll)
Gericht	dish, court
genießen	enjoy
bewegen	move
Geburtstag	birthday
ewig	forever; eternal
Schaden	damage
pro	per
traurig	sad; sadly
Gesellschaft	society, company
Punkt	point
Freiheit	freedom
darin	in it; inside
Weile	while
jawohl	of course
derselbe	the same
Maul	mouth (coll)
Taxi	taxi
erreichen	achieve
Foto	photo
unbedingt	necessarily; unconditional
aussehen	look (like); looks
drehen	turn
Tee	tea
erledigen	handle, take care of
Wein	wine
Weihnachten	Christmas
irgendwann	sometime
Lust	desire, pleasure
Bein	leg
Firma	company
lügen	lie
fürchten	be afraid of
kaputt	broken
Ball	ball
Haar	hair
seltsam	strange; strangely
weinen	cry
Vergnügen	pleasure; have fun
sauber	clean; neatly
Zuhause	home
Zeichen	sign
herein	in, inside
Liste	list
normal	normal; normally
schätzen	appreciate, estimate
Blick	look
stehlen	steal
vorne	ahead
neun	nine
nämlich	namely, after all
lehren	teach
wunderschön	beautiful, beautifully
freuen	look forward to; please
gehören	belong; be proper
schwören	swear
nervös	nervous; nervously
Hals	throat, neck
Glas	glass
verstecken	hide
Feind	enemy
verzeihen	forgive
öffnen	open
Madame	madame
süß	sweet
Entscheidung	decision
erschießen	shoot (dead)
verändern	change
wohnen	live, stay
Schuh	shoe
interessant	interesting; interestingly
übrigens	by the way
verraten	betray; reveal
besuchen	visit, attend
beweisen	prove
Sekunde	second
Insel	island
Gruppe	group
antworten	answer
werfen	throw
persönlich	personally; personal
gegenüber	opposite
Drink	drink
Fuß	foot
gucken	look (coll)
übrig	left, spare
Geheimnis	secret
ungefähr	about; approximate
nahe	near
Buch	book
Weib	woman (coll)
Zeitung	newspaper
zufrieden	satisfied; contentedly
zweiter	second
Loch	hole
Teufel	devil
statt	instead of
worauf	at what
sauer	sour, angry (coll)
erkennen	recognize
entfernt	remote; away
mitnehmen	take
Anruf	call
Traum	dream
kosten	cost; costs
Fisch	fish
schuldig	guilty; guiltily
zumindest	at least
entweder	either
miteinander	together
träumen	dream
sowas	something like that (coll)
schmerzen	hurt
fischen	fish
furchtbar	terribly; terrible
vorwärts	forward
teilen	share, divide
Kontakt	contact
entlang	along
Küche	kitchen, cuisine
wütend	angry; angrily
Überraschung	surprise
Gebäude	building
hängen	hang
Eis	ice, ice cream
zerstören	destroy
Koffer	suitcase
schwarz	black
Mann	man
witzig	funny; funnily
schließlich	finally; final
drinnen	inside
soweit	as far as; so far
entscheiden	decide
erhalten	get
bauen	build
Kleid	dress
übel	bad; badly
überleben	survive
hinaus	out
beeilen	hurry
beschäftigen	employ; deal
Verbindung	connection
Königin	queen
Ecke	corner
halb	half
Bericht	report
Vergangenheit	past
Radio	radio
Beziehung	relationship
feiern	celebrate
verhaften	arrest
Maschine	machine
ermorden	murder
regnen	rain
betrunken	drunk
irgendetwas	something
Gefühl	feeling
(da)rauf	on it; up (coll)
beginnen	start
Quatsch	nonsense (coll)
Hälfte	half
England	England
schwierig	difficult; hard
Respekt	respect
Adresse	address
häufig	often; common
besorgen	get, procure
parken	park; parking
Flug	flight
Agent	agent
Hund	dog
Schritt	step
au	ouch
Bombe	bomb
gelassen	calmly; calm
Aufgabe	task
allerdings	though, certainly
Prinzessin	princess
treten	step, kick
unterscheiden	distinguish
gesund	healthy
steigen	rise
besorgt	concerned; anxiously
Fluss	river
indem	as, by
bisher	so far
Tor	gate, goal
Glückwunsch	congratulation
blöd	stupid; stupidly
Hintern	butt; behind the
Dach	roof
Pistole	gun
leiden	suffer, tolerate
System	system
worüber	about what
Rennen	race; run
küssen	kiss
leisten	perform, afford
vermissen	miss
Verbrechen	crime; commit a crime
melden	report
verantwortlich	responsible
erfolgen	take place
besonderer	special
Natur	nature, countryside
Lächeln	smile
Auftrag	order, contract
aufhalten	stop
davor	before, before that
deutsch	German
überraschen	surprise
Baum	tree
leer	empty
morgens	in the morning
Wand	wall
schließen	close
schützen	protect
bestehen	exist, pass
rauchen	smoke; smoking
Schwierigkeit	difficulty
Stein	stone
mitten	in the middle
hinein	in, inside
Hose	pants
zuvor	before
prima	great; fine
Beruf	profession
lächerlich	ridiculous; ridiculously
beschützen	protect
befehlen	command, order
vermutlich	probably; suspected
englisch	English
gemeinsam	together; common
Pause	pause, break
aufpassen	pay attention
einverstanden	agreed
brechen	break
drucken	print
daher	therefore
übernehmen	take; overdo
Nachmittag	afternoon
Schätzchen	sweetie
Rock	skirt, rock music
fassen	take, believe
mitbringen	bring
dorthin	there
unterhalten	support; talk
angreifen	attack
beruhigen	calm
offensichtlich	obviously; obvious
kapieren	understand (coll)
frühstücken	have breakfast
stören	disturb
Farbe	color
zufällig	random; by chance
Mission	mission
Unternehmen	company
notwendig	necessary
fantastisch	fantastic; fantastically
Spur	track
Frühstück	breakfast
vertragen	tolerate, take
dienen	serve
verpassen	miss
Mörder	murderer
irgendwelcher	any
Stock	floor, stock, stick
mitkommen	come along
gewiss	certainly; certain
schmecken	taste
Reihe	line
fern	far; away
d(a)rüber	about it
Gang	gear, aisle gang
vollkommen	completely; perfect
rund	round
Restaurant	restaurant
Dreck	dirt
Untertitel	subtitle
warm	warm; warmly
Lager	stock, camp
atmen	breathe
daraus	from that
Gespräch	talk
leise	quietly; quiet
Flughafen	airport
schwanger	pregnant
Operation	operation
Gelegenheit	opportunity
dankbar	grateful; thankfully
Thema	theme
Verantwortung	responsibility
umsonst	free; for nothing
verbieten	prohibit
dick	thick; thickly
Nerv	nerve
erlauben	allow
Gast	guest
rollen	roll
Erfahrung	experience
rot	red
Gewalt	violence
entkommen	escape
riechen	smell
Strand	beach
aufstehen	get up
wahnsinnig	insane; madly
nachdenken	think
ober	upper; waiter
beenden	end
aha	aha, I see
Angebot	offer
gelten	apply to, be valid
Post	post office
Rolle	role
Frankreich	France
Gentleman	gentleman
Kugel	bullet, globe
Milch	milk
herausfinden	find out
mindestens	at least
Kuss	kiss
Knie	knee
worum	about what
graben	dig; ditch
voraus	ahead
blind	blind; unquestioningly
Schande	shame
Schönheit	beauty
Schatten	shade
schulden	owe
Badezimmer	bathroom
schwimmen	swim; swimming
formen	form
zweimal	twice
dunkel	dark; vaguely
siegen	win
Plan	plan; plain
Zufall	chance, coincidence
einladen	invite
Scherz	joke
gewöhnlich	usually; usual
Form	form
Fahrer	driver
ähnlich	similar (to); similarly
Verhalten	behavior; behave; cautious
Garten	garden
Großvater	grandfather
Energie	energy
Star	star
Kunst	art
Mädel	girl (coll)
Priester	priest
stoppen	stop, clock
Zustand	condition
Grenze	border
brennen	burn
Interesse	interest
Berg	mountain
soviel	as far as; so much
dringend	urgently; urgent
nutzen	use
entdecken	discover
Story	story
klingeln	ring
woanders	somewhere else
aufgeben	give up
bravo	bravo
nachher	later
stöhnen	groan
satt	full, rich
Sonntag	Sunday
woran	about what
normalerweise	usually
Kurs	course
anhalten	stop
Einheit	unit, unity
Mantel	coat
verlangen	require; desire
überlegen	consider; superior
Schüler	student
verbringen	spend
vorhin	earlier
Großmutter	grandmother
lauten	be (based)
durcheinander	mixed up
Dieb	thief
grenzen	border
weshalb	why
zweifeln	doubt
Zahn	tooth
kochen	cook; cooking
merken	notice, remember
verfolgen	pursue
Erinnerung	memory
fair	fair
längst	long ago
Norden	north
einsam	lonely, isolated
Koch	cook
Handy	cell phone
Gebiet	area
Abteilung	department
Kohle	coal, money (coll)
springen	jump, skip
tausend	thousand
Staat	state
scharf	sharp; sharply
langweilig	boring; boringly
teuer	expensive; dearly
abends	every evening
ebenso	as well
herzlich	cordially; cordial
Publikum	audience
Hemd	shirt
beten	pray
Stuhl	chair
Krankheit	illness
einander	each other
womit	with what
klug	clever; cleverly
Inspektor	inspector
selbstverständlich	of course; natural
jedoch	however
berufen	appoint; competent
schweigen	be silent; silence
Nachbar	neighbor
zählen	count
Song	song
trotz	despite; defiance
entlassen	dismiss
begraben	bury
Winter	winter
Vorstellung	idea, presentation
dadurch	in that
abholen	pick up
Medizin	medicine
schwach	weak; weakly
Rechnung	bill
wundervoll	wonderful; wonderfully
beinahe	almost
Presse	press
seitdem	since
Zunge	tongue
wirken	work; appear
spiegeln	reflect
handeln	act; concern
neulich	the other day
Streit	dispute
aufmachen	open; head off
bemerken	notice
Toilette	toilet
Trick	trick
freundlich	friendly; kindly
knapp	barely; tight
annehmen	accept
Termin	appointment, deadline
amen	amen
unschuldig	innocent; innocently
frisch	fresh; fresh
Bauch	stomach
decken	cover
überprüfen	check
Aufmerksamkeit	attention
Führer	leader, guide
vorbereiten	prepare
Hintergrund	background
reiten	ride (a horse); riding
außerhalb	outside
irgendjemand	somebody
Tatsache	fact
lösen	solve
Roboter	robot
drücken	press
nieder	low; down
erwachsen	adult; grow (up)
pressen	press, push
klauen	steal (coll.)
nackt	naked
unterschreiben	sign
vergeben	forgive, assign
Treppe	stairs
Erklärung	explanation
wild	wild; deer
Decke	blanket
spannend	exciting
Montag	Monday
Programm	program
lebendig	alive
bieten	offer, provide
Einsatz	use, commitment
peinlich	embarrassing
Wüste	desert
Schnee	snow
besprechen	discuss
Signal	signal
blau	blue; drunk (coll)
überzeugt	convinced
trauen	trust
wachen	(keep) watch
vorn(e)	at the front
zwölf	twelve
fremd	foreign, alien
ausgezeichnet	excellent; excellently
mehrere	several
hingehen	go (there)
eifersüchtig	jealous; jealously
hinterher	behind, afterward
behandeln	treat
ertragen	bear
desto	all the
zurückkommen	come back
Bedingung	condition
Unrecht	injustice; wrong
jederzeit	(at) any time
matt	matt, dull
nirgendwo	nowhere
auseinander	apart
offenbar	apparently; apparent
ausgehen	go out
selten	seldom; rare
schlau	smart; cleverly
wählen	choose
Truppe	troops
gebrauchen	use
packen	pack, grab
landen	land
Bedeutung	meaning
amerikanisch	American
betreffen	affect
Jacke	jacket, coat
(he)reinkommen	come in
streiten	argue
fressen	eat (coll), devour
greifen	grip, reach
Erlaubnis	permission
Bahn	railroad, train
kontrollieren	check, control
Kuh	cow
Träne	tear
Geschmack	taste
schief	crooked; awry
dritter	third
ernsthaft	seriously; serious
dennoch	yet; still
Absicht	intention
stechen	stab; sting
Labor	laboratory
extra	extra
Eindruck	impression
anscheinend	apparently; apparent
verhindern	prevent, stop
weitermachen	carry on
Prozent	percent
schneiden	cut
verwirrt	confused
erfreut	pleased
erwähnen	mention
Mühe	effort
Code	code
Linie	line
trennen	separate
Gift	poison
aufregen	upset, excite
Brief	letter
probieren	try, test
weiterhin	further on
begleiten	accompany
Zucker	sugar
angehen	address, approach
erleben	experience
fliehen	escape
Untersuchung	investigation, examination
Stil	style
Kiste	box
Flucht	escape
hungrig	hungry; hungrily
Kleidung	clothes
menschlich	human; humanly
innerhalb	within; inside
gleichzeitig	at the same time; simultaneous
Beeilung	hurry (up)
Projekt	project
null	zero
irgendein	any
Gerechtigkeit	justice
grün	green
Ei	egg
spitze	great (coll); tip
anziehen	attract, put on
(he)rein	in, purely; pure
heutzutage	nowadays
Not	need, distress
wahren	maintain
getrennt	separated; separately
punkten	score
raten	advise, guess
gründen	establish
treiben	drive, push
Strom	current, electricity
fett	fat
enttäuscht	disappointed
ankommen	arrive
Mittag	noon
Explosion	explosion
locker	loose; loosely
Gnade	mercy
zuhören	listen
beobachten	observe
fein	fine; finely
klopfen	knock
Künstler	artist
gemein	mean, common; wickedly
zuletzt	last, in the end
schnappen	grab, catch
eilig	urgent, in a hurry
festhalten	hold
Scheck	check
Person	person
dahinter	behind it
Bürger	citizen
Gegenteil	opposite
geöffnet	open
dicht	dense; densely
französisch	French
d(a)rum	about it
aufnehmen	take, record
Benehmen	behavior, behave
Magen	stomach
Hof	yard
erfüllen	meet, fulfill
verteidigen	defend
Hütte	hut
verbunden	connected
gesamt	entire
Fabrik	factory
wiederholen	repeat
spazieren	walk, stroll
befreien	free
abgeschlossen	enclosed, closed
Titel	title
inzwischen	meanwhile, by now
Uniform	uniform
Kollege	colleague
streng	strictly; strict
wechseln	change
Benzin	petrol
bestellen	order
starten	start
anfassen	touch
praktisch	practically; practical
abmachen	arrange, remove
vernichten	destroy
waschen	wash
überlassen	leave
vernünftig	reasonable; sensibly
dauernd	constantly; continuous
untersuchen	examine
herkommen	come here; origin
begegnen	meet
wachsen	grow
ebenfalls	also, likewise
spüren	feel
Freundschaft	friendship
antun	do (to)
riskieren	risk
Markt	market
Cousin	cousin
Aufnahme	admission, recording
derjenige	the one who
Sand	sand
Narr	fool
verschieden	different; differently
Müll	garbage
stets	always
Studio	studio
geheim	secret; secretly
Ratte	rat
ergeben	result in; devoted
entwickeln	develop
Figur	figure
bewusst	aware; consciously
Datum	date
Scheidung	divorce, separation
reparieren	repair
geil	awesome; horny (coll)
überzeugen	convince
hundert	hundred
Verbrecher	criminal
ruinieren	ruin
umgehen	handle, bypass
empfangen	receive
Universum	universe
Schrank	cabinet
Reifen	tire; mature
täglich	daily; every day
erfinden	invent
zurückkehren	return
Besitzer	owner
achten	respect, pay attention
Notfall	emergency
möglicherweise	possibly
gratulieren	congratulate
Gesundheit	health
anstatt	instead of; rather than
Ware	goods
deutlich	clearly; clear
berühmt	famous
rechtzeitig	in time; timely
bestens	very well
vereinigen	unite
einst	once
lebend	alive
West	west
Mitglied	member
gegenseitig	each other; mutual
akzeptieren	accept
neugierig	curious; curiously
warnen	warn
aufwachen	wake up
daneben	next to it
Beerdigung	funeral
geraten	get; advisable
Kreuz	cross
besitzen	own
erschaffen	create
brav	good, wellbehaved
befinden	be situated; decide
komplett	complete, completely
eng	tight; closely
Theorie	theory
Pilot	pilot
lärmen	make a noise
wonach	for what
Gedanke	thought
meistens	mostly
entspannen	relax
Realität	reality
zwingen	force
äußerst	extremely; exceeding
beschließen	decide
Ursache	cause
zulassen	let, admit
Schuss	shot
angenehm	pleasant; pleasantly
Suppe	soup
Land	country
Unterstützung	support
übergeben	hand over; vomit
jagen	hunt
eilen	hurry
Sicht	view
Verteidigung	defense
sexy	sexy
immerhin	at least
Flügel	wing
aufregend	exciting
Krebs	cancer, crab
Knopf	button
Verabredung	appointment
auftreten	occur
Stellung	position
negativ	negative; negatively
richten	focus
Bahnhof	station
fähig	capable
Krankenwagen	ambulance
Manager	manager
Text	text
Gedächtnis	memory
erscheinen	appear
Wissenschaft	science
ausziehen	take off, move out
Bande	gang
prost	cheers
rosa	pink
umdrehen	turn
beantworten	answer
Leidenschaft	passion
berühren	touch
Unterhaltung	entertainment, conversation
Donnerstag	Thursday
Gesetz	law
berichten	report
Start	start
loswerden	get rid of
Zweck	purpose
mieten	rent
sicherlich	certainly
Revolution	revolution
Pizza	pizza
schenken	give
plus	plus
Virus	virus
stammen	come
Kanone	gun
malen	paint
erstaunlich	amazing; surprisingly
bestrafen	punish
Versagen	failure, fail
geliebt	beloved
Schauspieler	actor
unglücklich	unhappy; unhappily
Reporter	reporter
taub	deaf
konzentrieren	concentrate
beeindrucken	impress
Braut	bride
kompliziert	complicated
jener	that
Vermögen	fortune; achieve
Legende	legend
Wut	anger
fällen	make, fell
Seil	rope
knarren	creak
Einstellung	attitude, setting
hässlich	ugly
Viertel	quarter
behaupten	claim
verurteilen	condemn
Höhe	height
Jungfrau	virgin
Anweisung	instruction
Schulter	shoulder
gewöhnen	get used to
Applaus	applause
Mittel	means; medium
innen	inside
Japan	Japan
Stärke	strength
Klinik	clinic
per	by, per
verbrennen	burn
sparen	save
urteilen	judge
klären	clarify
anschauen	look at
Einladung	invitation
zusehen	watch
Milliarde	billion
entfernen	remove
Ruhm	fame, glory
bewahren	preserve, keep
Verdacht	suspicion
Fan	fan
studieren	study
Belohnung	reward
heben	lift
Bereich	area
Universität	university
Hügel	hill
Sünde	sin
erfolgreich	successfully; successful
hervorragend	excellent; excellently
Regen	rain; move
Tunnel	tunnel
einsperren	lock up
albern	silly
Ausweis	ID
aussteigen	get off, exit
weitergehen	go on
elf	eleven
See	sea; lake
Angelegenheit	matter
bequem	comfortably; comfortable
Posten	post; item
weich	soft; smoothly
nass	wet
einkaufen	shop; shopping
Puppe	doll
duschen	shower
daheim	at home
(he)rauskommen	come out
erstens	first(ly)
Mauer	wall
korrekt	correctly; correct
überfallen	attack
Lektion	lesson
live	live
Konzert	concert
beibringen	teach
Schild	sign; shield
wenden	turn
Öffentlichkeit	public
mutig	brave; bravely
Schwanz	c*ck (coll), tail
Kreis	circle
verabschieden	say goodbye; pass
Tiger	tiger
Museum	museum
Dusche	shower
eindeutig	clearly; unique
segnen	bless
offiziell	officially; official
steuern	control
lecker	delicious
Krone	crown
Roman	novel
nix	nothing (coll)
Material	material, stuff
Kühlschrank	fridge
unheimlich	scary; incredibly
kreisen	circle
Drache	dragon
prüfen	check
Liebhaber	lover
real	real
verdächtigen	suspect
betreten	enter; embarrassed
Palast	palace
anbieten	offer
Wunde	wound
Warnung	warning
September	September
begeistert	excited; enthusiastically
Umstand	circumstance
Regisseur	director
ausgerechnet	just, of all
Behandlung	treatment
telefonieren	phone
spanisch	Spanish
weggehen	leave
Fieber	fever
Verfügung	disposal
gewohnt	usual, accustomed
Charakter	character
folgend	following
nebenan	next door, alongside
unterstützen	support
Modell	model
verwenden	use
Kopie	copy
Pille	pill
Paradies	paradise
Haken	hook
zugeben	admit, add
Furcht	fear
definitiv	definitely; definite
Versicherung	insurance
hinsetzen	sit down
loslassen	let go
aufgrund	because of
Asche	ash
kichern	giggle
bestätigen	confirm
dramatisch	dramatic; dramatically
Training	practice
besiegen	defeat, beat
pünktlich	on time; punctual
sammeln	collect; gather
Technik	technology
beleidigt	offended; sulkily
Höhle	cave
Laster	truck (coll)
wovor	of what
seufzen	sigh
üben	practice
übersetzen	translate
voran	forward
Gewicht	weight
schocken	shock
zentral	central; centrally
Ankunft	arrival
Konto	account
senden	send
besessen	obsessed
schmutzig	dirty
Hafen	port
Verlust	loss
Zugang	access
jenseits	beyond
Apparat	device
Führerschein	driver's license
freiwillig	voluntary; voluntarily
Antrag	request
Gewinner	winner
pleite	broke (coll); bankruptcy
Senator	senator
sowie	as well as
genügen	suffice
Terrorist	terrorist
zweitens	secondly
Stift	pen
widerstehen	resist
verabreden	arrange
Zentrale	headquarters
einstellen	adjust, hire; appear
räumen	vacate
meinetwegen	because of me, whatever (coll)
morden	murder
ausruhen	rest
unwichtig	unimportant
schieben	push
abnehmen	lose weight, remove
tauschen	exchange
dreimal	three times
Gemeinde	community
begehen	commit
treu	faithful; faithfully
attraktiv	attractive; attractively
Quelle	source
August	August
beschreiben	describe
blasen	blow
grausam	cruel; cruelly
Wäsche	laundry
betrachten	consider, look at
wecken	wake
leiten	conduct, guide
ablehnen	refuse
liefern	provide, deliver
leihen	lend; borrow
extrem	extreme, extremely
Bestie	beast
darunter	below; among them
amüsieren	amuse
Werbung	advertising
Jäger	hunter
Uni	university (coll); plain
reizend	lovely; gracefully
verschwenden	waste
Marine	navy
Spanien	Spain
herrschen	rule
sozusagen	so to speak
anstellen	hire, line up
trocken	dry; dryly
Führung	leadership, guide
Witwe	widow
Fähigkeit	ability, skill
Frühling	spring
Weihnachtsmann	Santa Claus
scheiden	divorce
stattdessen	instead
Rad	wheel, bike
Bibel	Bible
höchstens	at most
verzweifelt	desperately; desperate
Feigling	coward
hell	bright; brightly
abgeben	submit, make
Herzog	duke
nirgends	nowhere
Abenteuer	adventure
Ausdruck	expression
sinnlos	pointless; senselessly
reißen	tear
begreifen	understand
bereiten	prepare, cause
Zirkus	circus
nützlich	useful
vermuten	suspect
Tempel	temple
nachsehen	check
tapfer	brave; bravely
Ferien	vacation
kennenlernen	meet, get to know
bescheuert	nuts (coll)
vermeiden	avoid
Trainer	coach
entgegen	contrary to; towards
Gesang	singing
auffallen	stand out, notice
Truck	truck
bilden	form
Minister	minister
bereuen	regret
Teller	plate
erschöpfen	exhaust
typisch	typical; typically
König	king
Abschied	farewell
Autor	author
nochmals	again
Einspruch	objection
Funken	spark; radio
heutig	today's
Tropfen	drop, drip
Test	test
doppelt	double; twice
einsteigen	get in
Organisation	organization
Heirat	marriage
ungern	reluctantly
riesig	huge; enormously
keuchen	gasp
strafen	punish
umziehen	move; change
herrlich	wonderful; beautifully
leeren	empty
junior	junior
Verrat	betrayal
Katastrophe	disaster
Strafe	punishment
Blitz	lightning
verkehren	socialize, run
identifizieren	identify
Mitarbeiter	employee, coworker
vergewaltigen	rape
(he)rausholen	get out
Gelächter	laughter
begrüßen	welcome, greet
Kanal	channel, sewer
Laune	mood
Vorteil	advantage
Verfahren	procedure; proceed
Kette	chain
mächtig	powerful; mightily
nützen	benefit
Aufregung	excitement,
hereinlegen	trick (coll)
schämen	be ashamed
marsch	march
hurra	hurray
bewaffnen	arm
weisen	point
Gegenwart	presence, present
Sekretärin	secretary
Ladung	load
Bauer	farmer
einzeln	individually; single
Spion	spy
beeindruckend	impressive; impressively
Vieh	cattle
informieren	inform
Täter	perpetrator
zwanzig	twenty
außen	outside
erheben	raise, charge
(he)reingehen	go in
momentan	currently; current
verbinden	connect
Reaktion	reaction
platt	flat
verbergen	hide
herunter	down
Hinweis	hint, reference
schüchtern	shy; shyly
Mittwoch	Wednesday
Magie	magic
Zivilisation	civilization
Mannschaft	team
inner	internal
stürzen	fall, overthrow
nähern	move closer
Rose	rose
Kapitel	chapter
Bär	bear
hinunter	down
zunächst	first
großzügig	generous; generously
heimlich	secretly; secret
unhöflich	rude; impolitely
Schachtel	box
soeben	just
Kehle	throat
beißen	bite
Betrüger	fraud
umso	all the more
irren	be wrong
Aussicht	view, prospect
schwächen	weaken
Ausbildung	education
Spinner	weirdo (coll)
erstmal	for now (coll)
Scheibe	disc, slice
verlobt	engaged
golden	golden
Schwäche	weakness
grüßen	greet
Juni	June
verwunden	wound
Aufzug	elevator
zeihen	accuse (fml)
testen	test
sachte	gentle; gently (coll)
Gewehr	gun, rifle
entschlossen	determined; determinedly
Unterschrift	signature
weglaufen	run away
Lieferung	delivery
geradeaus	straight
bekämpfen	combat
Objekt	object
Profi	professional, pro (coll)
Schläger	bat, beater
mitmachen	join in
lohnen	be worth, reward
Admiral	admiral
anklagen	accuse, charge
Personal	staff, personal
Eingang	entrance
Ausgang	exit
Kamera	camera
explodieren	explode
anzeigen	indicate
Motorrad	motorcycle
erneut	again; renewed
billig	cheap; cheaply
pfeifen	whistle
fröhlich	cheerful; cheerfully
Service	service, set
Besucher	visitor
Technologie	technology
pflanzen	plant
Geschwindigkeit	speed
salzen	salt
Fantasie	imagination
flüstern	whisper
gestatten	allow
anständig	decent; decently
illegal	illegal; illegally
romantisch	romantic, romantically
verhandeln	negotiate, deal with
unterliegen	be subject to
Flamme	flame
keinerlei	absolutely no
auftauchen	show up
Exzellenz	excellency
Toast	toast
ungewöhnlich	unusual; unusually
besetzt	occupied, busy
vergleichen	compare
Käfig	cage
Daumen	thumb
spinnen	spin, be mad (coll)
existieren	exist
Spielzeug	toy
durchsuchen	search
Wirkung	effect
bedanken	thank
Abschluss	graduation, conclusion
Brieftasche	wallet
wehtun	hurt
intelligent	intelligent; intelligently
vorbeikommen	stop by
gerecht	just; fairly
Leber	liver
betragen	be, amount to
(he)rausfinden	find out
Kämpfer	fighter
ordentlich	properly; tidy
täuschen	deceive, be wrong
sanft	gently; soft
diskutieren	discuss
Aktion	action
Marke	brand
Behörde	authority
positiv	positive; positively
anhören	listen to
Spinne	spider
Stirn	forehead
verderben	spoil
Maus	mouse
glatt	smooth; smoothly
Verständnis	understanding
Café	café
aufwachsen	grow up
ausrichten	adjust, tall
Leinen	linen
garantieren	guarantee
Umgebung	environment, neighborhood
widerlich	disgusting; disgustingly
wiederkommen	come back
Fleck	spot
bezweifeln	doubt
vergehen	pass
Aktie	share, stock
einfallen	come to mind, invade
ausmachen	make out
pinkeln	pee (coll)
Belieben	convenience; please
Erzähler	narrator
zaubern	do magic
Zaun	fence
Dämon	demon
eingehen	enter
Tradition	tradition
befreunden	make friends
Generation	generation
Tipp	hint, tip
Übersetzung	translation,
rechnen	count, estimate
werten	evaluate
allzu	overly
aufmerksam	attentive; closely
einig	agreed, united
einschlafen	fall asleep
Stufe	step
grob	rough; roughly
üblich	usual
Parkplatz	parking lot
Interview	interview
aussuchen	pick
ertönen	sound
verwandeln	transform
Unterwäsche	underwear
fabelhaft	fabulous; fabulously
schluchzen	sob
knallen	bang
hinweg	away
Camp	camp
interviewen	interview
trainieren	train
ansonsten	otherwise
Zone	zone
Abschaum	scum (coll)
Seife	soap
Strecke	route
ohnmächtig	unconscious
scheinbar	seemingly; apparent
Puls	pulse
ekelhaft	disgusting; disgustingly
köstlich	delicious; deliciously
Krawatte	tie
campen	camp
Oper	opera
entführen	kidnap
Geisel	hostage
Version	version
strecken	stretch
Pirat	pirate
durchmachen	undergo
d(a)raus	out of it
Hühnchen	chicken
minus	minus
Vampir	vampire
letztendlich	eventually
sprengen	blow up
anschießen	shoot
füllen	fill
quietschen	squeak
Villa	villa
vermasseln	mess up (coll)
Tragödie	tragedy
faul	lazy; lazily
Krise	crisis
breit	wide; broadly
verprügeln	beat up
Grad	degree
heran	closer
durchaus	quite, absolutely
genial	brilliant; ingeniously
tauchen	dive
Brust	chest, breast
feige	cowardly
Salat	lettuce, salad
Butter	butter
kürzlich	recently; recent
Summe	sum
Brand	fire
ignorieren	ignore
putzen	clean
Ausrede	excuse
Trost	comfort
angeln	fish; fishing
erschrecken	scare
flott	fast (coll)
unterbrechen	interrupt
Schnaps	booze (coll)
Motiv	motive
verteilen	distribute, distribution
Serie	series
Irrtum	error
verschließen	close
Motel	motel
Kultur	culture
bedenken	consider; concerns
Experiment	experiment
ausgeben	spend, issue
verwickeln	involve, engage
übersehen	overlook
Mafia	mafia
Baseball	baseball
gemütlich	cozy; snugly
Sieger	winner
sichern	ensure
hinlegen	lay down; lie down
losgehen	start
Identität	identity
bestimmen	determine
Brett	board
Flieger	aviator, plane (coll)
Welle	wave
Telefonnummer	phone number
chinesisch	Chinese
verrücken	move, shift
(he)rausgehen	go out
ersetzen	replace
dünn	thin
Experte	expert
Kofferraum	trunk
rückwärts	backward
Clown	clown
verärgert	upset; crossly
genügend	enough
Handtuch	towel
Verschwörung	conspiracy
präsentieren	present
Öl	oil
Saal	room, hall
gefälligst	kindly (coll)
Sklave	slave
mies	lousy (coll)
Verhandlung	negotiation
Vorfahre	ancestor
beherrschen	control
reagieren	react
Versager	failure
brillant	brilliant; brilliantly
vergiften	poison
ölen	oil
lediglich	only
Melodie	melody
weswegen	why
aussetzen	expose
eröffnen	open
Ritter	knight
bewundern	admire
privat	private; privately
Weisheit	wisdom
kotzen	puke (coll)
friedlich	peaceful; peacefully
vorüber	past, over
unangenehm	unpleasant; unpleasantly
Verräter	traitor
Ereignis	event
Zahnarzt	dentist
verpflichten	oblige, commit
Flagge	flag
zurückgeben	return
Wirtschaft	economy
Platte	plate
Mutter	mother
bedauern	regret
höflich	polite; cordially
Verspätung	delay
Kommentar	comment
Sitzung	meeting
absichtlich	intentionally; intentional
absurd	absurd; absurdly
Rezept	recipe, prescription
Koma	coma
Muskel	muscle
Gürtel	belt
hinauf	up
russisch	Russian
einsetzen	use, insert; commit
irgendwohin	somewhere
löschen	delete
vertreten	represent
Therapie	therapy
verlieben	fall in love
vergangen	past
zuständig	responsible
überwachen	monitor
Couch	couch
bedienen	operate, serve
boxen	box
Kombination	combination
irgendwer	anyone
Zerstörung	destruction
Einsamkeit	loneliness
versehen	provide; overlook; oversight
backen	bake
Ausnahme	exception
Räuber	robber
nutzlos	useless
husten	cough
verdächtig	suspicious; suspiciously
Chip	chip
zurückgehen	go back
versichern	assure, insure
Hausaufgabe	homework
unfair	unfair; unfairly
Kater	hangover (coll), tomcat
hierhin	here
überfahren	run over
mitteilen	tell
enttäuschen	disappoint
Herausforderung	challenge
Akzent	accent
brutal	brutally; brutal
höchst	highly; superlative
Ansicht	opinion
Zoo	zoo
beteiligen	participate
Huhn	chicken, hen
Rasen	lawn; dash
Gehalt	salary; content
vollständig	completely; full
Lkw	truck (abr)
zurückbringen	bring back
Elend	miserable; misery
Spritze	shot, injection
Sofa	sofa
anlegen	invest, apply
Wahnsinn	madness
ärgern	annoy
abwarten	wait
stinken	stink
Zustimmung	approval
beunruhigt	worried
fließen	flow
Sammlung	collection, gathering
Vorfall	incident
Akt	act, nude
Temperatur	temperature
ungeheuer	enormous; enormously; monster
Polen	Poland
Artikel	article
gelangen	get to
ausgeschlossen	impossible
geschieden	divorced
Kabine	cabin
tanken	refuel
dazwischen	between
aufheben	cancel, pick up
charmant	charming, charmingly
Futter	feed
rudern	row
Nadel	needle
frech	cheeky; impudently
jahrelang	for years
Saison	season
Brite	British
Paket	package
verzichten	do without
Ferne	distance
bremsen	brake
Dealer	dealer
übernachten	stay overnight
vorhaben	plan
Kleinigkeit	little thing
Hotel	hotel
Erfindung	invention
Meldung	message
logisch	logical; logically
Veränderung	change
Philosophie	philosophy
umgeben	surround
Tankstelle	gas station
Januar	January
Japaner	Japanese
hinweisen	point, refer
ausdenken	come up with
piepen	beep; bucks (coll)
bewusstlos	unconscious
gestehen	confess
Umschlag	envelope
Schädel	skull
marschieren	march
verlaufen	run, get lost
gehorchen	obey
nüchtern	sober; soberly
Politiker	politician
faszinierend	fascinating; fascinatingly
politisch	political; politically
Schneider	tailor, cutter
anlügen	lie to
vierter	fourth
Demokratie	democracy
fesseln	tie up
hüten	guard
Schuppen	shed; dandruff
Herbst	autumn
wegnehmen	take away
zweifellos	undoubtedly; doubtless
Eisen	iron
Steak	steak
heftig	violently; violent
Versammlung	meeting
schrecken	scare; terror
Einbruch	burglary, collapse
Kompliment	compliment
Bezirk	district
zurzeit	currently
antreten	compete, start
Mütze	cap, hat
Diebstahl	theft
vielmals	many times
ahnen	anticipate
vereinen	unite
medizinisch	medical; medically
Wurm	worm
Wärme	warmth
Schlag	blow
entspannt	relaxed
Möbel	furniture
jubeln	cheer
sowohl	and, as well as
gering	low, small
Ermittlung	investigation
Diskussion	discussion
wärmen	warm
befragen	consult, question
verhungern	starve
stoßen	bump, butt
Studium	study
beleidigen	offend
Münze	coin
Landung	landing
übertreiben	exaggerate
zittern	tremble
Prinz	prince
Fahne	banner
Schach	chess
Gegensatz	contrast
Rebell	rebel
Tüte	bag
Bude	hut
Gestank	stench
Klient	client
hauptsächlich	mainly; main
andermal	another time
Vorschrift	rule
Etage	floor, level
Zusammenhang	connection, context
Schwachkopf	moron (coll)
festnehmen	arrest
Schaf	sheep
Regie	direction
füttern	feed
grau	grey
Verhältnis	relationship
Bach	brook
erobern	conquer
Löwe	lion
niedlich	cute
schlucken	swallow
Skandal	scandal
Reichtum	wealth
Sonnenuntergang	sunset
einnehmen	take
verbessern	improve
aushalten	bear, stand
Korb	basket
fortschreiten	progress
ausdrücken	express
Neffe	nephew
einschließen	involve, trap
heilen	heal
tödlich	fatal; mortally
bluten	bleed
Narbe	scar
Würstchen	sausage
Schlange	snake, line
betreiben	operate
bewachen	guard
besoffen	drunk (coll)
Stange	pole
Hure	whore
Pfad	path
Berater	consultant
respektieren	respect
unnötig	unnecessary; needlessly
Protokoll	minutes, protocol
organisieren	organize
Fuchs	fox
übertragen	transfer; figurative
Vorgehen	approach, proceed
unsichtbar	invisible, unseen
Nachbarschaft	neighborhood
belästigen	bother
wundern	surprise; wonder
Boot	boat
Haltung	attitude, pose
klagen	complain
rasch	quickly; rapid
reif	ripe, ready
überreden	persuade
Cent	cent
versammeln	gather
Bargeld	cash
Zeuge	witness
Bock	buck, ram
erregen	excite, attract
Gemüse	vegetables
Winkel	angle
wobei	in which; when
nebenbei	by the way
krachen	crash
Keks	biscuit
Gräfin	countess
Kratzer	scratch
Friseur	hairdresser
Halle	hall
Knoten	knot
Konferenz	conference
aufbauen	build up
Kaution	deposit
unterrichten	teach, inform
gründlich	thoroughly; thorough
öffentlich	public; publicly
verdanken	owe
gespannt	curious; eagerly
eigenartig	peculiar; peculiarly
Cash	cash
königlich	royal, royally
keineswegs	by no means
ohnehin	anyway
Orange	orange
Eifersucht	jealousy
Gestalt	shape, character
melancholisch	melancholy; melancholically
unbekannt	unknown
Geschäftsmann	businessman
andererseits	on the other hand
Blutdruck	blood pressure
legal	legal; legally
Bezug	relation, reference
japanisch	Japanese
fordern	demand
Cowboy	cowboy
Rente	pension
Spannung	tension, voltage
Ex	ex
mitfahren	go with
Anspruch	claim
abhalten	discourage
empfehlen	recommend
versorgen	provide
modern	modern; modernly
Lunge	lung,
blond	blond
arrangieren	arrange
Herzinfarkt	heart attack
enthalten	contain; refrain
Honig	honey
Rollstuhl	wheelchair
Kreatur	creature
Zwilling	twin
Vergewaltigung	rape
engagieren	engage
harmlos	harmless; harmlessly
streichen	strike, delete
Häuptling	chief
quitt	quits
braun	brown
bezüglich	regarding
zustimmen	agree
bellen	bark
klettern	climb
anwesend	present
Lastwagen	truck
Ruhestand	retirement
benötigen	need
Karre	cart
entsprechen	correspond
verwandt	related
gnädig	gracious; graciously
Ticket	ticket
aufrichtig	sincere; sincerely
gesegnet	blessed
riskant	risky, dangerously
Album	album
Zutritt	access
unsicher	uncertain; uncertainly
rasieren	shave
empfinden	feel
gelb	yellow
läuten	ring
geschäftlich	commercial, commercially
verlegen	embarrassed; move; sheepishly
vergraben	bury
Missverständnis	misunderstanding
Konzept	concept
Kleingeld	change
Tabak	tobacco
Senat	senate
hervor	out
britisch	British
Schwager	brotherinlaw
Entführung	kidnapping
verschieben	move
vorkommen	occur, exist
Apfel	apple
Mode	fashion
Kacke	poo (coll)
exakt	exact; exactly
umarmen	hug
Klemme	jam (coll)
endgültig	final; finally
hilfreich	helpful
Werkzeug	tool
doof	stupid (coll)
bumsen	f*ck (coll), thump
aufstellen	establish; line up
Stab	rod
lokal	local; locally; pub (coll)
Buchstabe	letter, character
vertreiben	expel
insgesamt	altogether
herstellen	produce
abbrechen	cancel, stop
jährig	*year
Streifen	strip; brush
wertvoll	valuable
Duft	scent
erziehen	bring up
Zwerg	dwarf
Buchhalter	accountant
messen	measure
Lizenz	license
behilflich	helpful
Schwede	Swede
stabil	stable; sturdily
Hahn	tap, rooster
ergreifen	seize, take
bedeckt	covered, overcast
Kneipe	bar (coll)
Software	software
Pfeil	arrow, dart
herbringen	bring (here)
jedermann	everyone
Verletzung	injury, violation
erweisen	prove
Kongress	congress
Gemeinschaft	community
versetzen	move, transfer
umwerfend	stunning; stunningly
zurückziehen	withdraw
Wohnwagen	caravan
Autounfall	car accident
weiblich	female, feminine
biegen	bend
gratis	free
mangeln	lack
durchziehen	pull through
schmeißen	throw (coll)
durchgehen	go through, be allowed
Geschrei	shouting
knacken	crack
verirren	get lost
reichlich	plenty
irre	crazy, maniac
Batterie	battery
dreckig	filthy
übermorgen	day after tomorrow
angeklagt	accused
Torte	cake
andauernd	constantly; ongoing
Löffel	spoon
hinüber	across
Angesicht	face
klassisch	classical, classically
Gelände	terrain
naiv	naive; naively
umgekehrt	vice versa; reversed
vorlesen	read aloud
Dankeschön	thankyou
hierbleiben	stay here
Original	original
Notiz	note
überaus	extremely
Besatzung	crew, occupation
Finsternis	darkness
Verhaftung	arrest
gebunden	tied
Feuerzeug	lighter
sämtlich	all; altogether
beschädigt	damaged
Beamte	civil servant
kräftig	strong; strongly
leck	leaky; leak
Garderobe	wardrobe
gelingen	succeed; success
einzigartig	unique; uniquely
belügen	lie to
sperren	lock, block
Nation	nation
Schere	scissors
beauftragen	instruct, commission
Besprechung	meeting
eklig	yukky (coll)
einziehen	move in
Kellner	waiter
Stiefel	boot
Kram	junk (coll)
Donner	thunder
Holz	wood, timber
Abstand	distance
Gras	grass, weed (coll)
Ufer	shore
phantastisch	fantastic; fantastically
Vogel	bird
Ort	place
Werk	work, factory
Staub	dust
anrichten	cause
Fahrstuhl	elevator
international	international; internationally
anfangs	at first
unverständlich	incomprehensible; incomprehensibly
Beförderung	promotion, transportation
ausfahren	extend, drive out
Trip	trip
überqueren	cross, pass
Kerze	candle
checken	check
Hochzeit	wedding
Vergebung	forgiveness
Probe	rehearsal, trial
womöglich	possibly
Hamburger	hamburger
Sprengstoff	explosive
fit	fit
Herd	stove
kündigen	cancel
Kragen	collar
somit	thus
Dankbarkeit	gratitude
hinfahren	go (there)
Vorsitzender	chairman
tagsüber	during the day
angesichts	considering
Konkurrenz	competition
operieren	operate
Regiment	regiment
Aspirin	aspirin
Zigeuner	gypsy
Aktivität	activity
ausschalten	turn off
Nudel	noodle
zeichnen	draw, sign
Konversation	conversation
Verzweiflung	despair
Attentat	assassination
Schalter	switch, counter
bezeichnen	call
zufolge	according to
ideal	ideal; ideally
Einbrecher	burglar
beschweren	complain, weight
Dinner	dinner
Trennung	separation
Evolution	evolution
Geier	vulture
entstehen	arise
Dolch	dagger
Beschreibung	description
trommeln	drum
Auswahl	selection
umher	around
weltweit	worldwide
Handlung	act, plot
eventuell	possibly; possible
Koordinate	coordinate
erteilen	grant, issue
Ballett	ballet
Einzelheit	detail
apropos	by the way
brüllen	roar; roaring
wehren	oppose (coll); fight back
arabisch	Arabic
dämlich	silly (coll)
Käfer	beetle
beurteilen	judge
hilflos	helpless; helplessly
Niederlage	defeat
Katze	cat
starren	stare
lila	purple
Schublade	drawer
vorschlagen	suggest
egoistisch	selfish; selfishly
Highway	highway
Dummheit	stupidity, silliness
erhöhen	increase
Entdeckung	discovery
locken	lure; curl
Feder	feather
Zuneigung	affection
beiseite	aside
regieren	rule
Begrüßung	greeting
Vorgesetzte	superior
laufend	constantly; running
Hinrichtung	execution
beeinflussen	influence
Dokument	document
feststellen	determine
Agentur	agency
deprimieren	depress
Teenager	teenager
geeignet	suitable; suitably
Anhänger	pendant, follower
braten	roast
aussagen	testify
feucht	damp
Tafel	board, bar
ablegen	discard
kriechen	crawl
Dampf	steam
Autorität	authority
hupen	honk
Tarnung	disguise
gütig	kind; kindly
bemühen	attempt; effort
ausgebildet	educated
eintreten	enter, occur
Schirm	umbrella, screen
Sirene	siren
steif	stiff; stiffly
Schweiz	Switzerland
Sonnenschein	sunshine
heulen	howl
spucken	spit
blockieren	block
Transport	transport
d(a)runter	below
weiterleben	live on
Abmachung	arrangement
beschuldigen	accuse
fotografieren	photograph; photographing
veröffentlichen	publish
unwahrscheinlich	unlikely
Läufer	runner
zusammenarbeiten	cooperate
glotzen	stare (coll)
Standpunkt	position
Gebet	prayer
ausstehen	stand, bear
Februar	February
Gen	gene; towards (fml)
segeln	sail
auflegen	hang up, issue
Mönch	monk
Erbarmen	mercy; arouse pity
prügeln	fight
bedürfen	require, need
allmählich	gradually; gradual
aufrecht	upright
Telegramm	telegram
hoffnungslos	hopeless; hopelessly
aussprechen	express, pronounce
verbreiten	spread
kehren	sweep, turn
Vorhang	curtain
zugelassen	authorized
plaudern	chat (coll)
erfordern	require
Ausländer	foreigner
befolgen	follow, obey
wiegen	weigh, cradle
ausgesprochen	pronounced; extremely
kühl	cool; unemotionally
gelegentlich	occasionally; occasional
Wandern	hike; hiking
zurücklassen	leave (behind)
ertrinken	drown
aufbrechen	leave, break
aktiv	active; actively
Kern	core
beachten	consider, observe
Draht	wire
hysterisch	hysterical; hysterically
zurückrufen	call back
Sprecher	speaker
Verkäufer	seller
abhängig	addicted, dependent; dependently
neidisch	envious; enviously
Begleitung	company
ausrauben	rob
italienisch	Italian
Koks	coke (coll)
Analyse	analysis
Tänzer	dancer
umsehen	look around
durchdrehen	go crazy (coll), spin
Andenken	memory, souvenir
Kutsche	carriage
entgehen	avoid
Begräbnis	burial
beruflich	professional, professionally
Vollidiot	retard (coll)
aufräumen	tidy (up); tidying up
verehren	worship
Axt	ax
Versuchung	temptation
fade	bland; tastelessly
Privatleben	private life
mischen	mix, mingle
drohen	threaten
Bastard	bastard
Beute	prey
Blues	blues
alternativ	alternative; alternatively
Zeitschrift	magazine
hindern	prevent
Blatt	leaf, page
würdig	worthy; worthily
betteln	beg
eintreffen	arrive; arrival
erleichtert	relieved
Anschlag	assault
mehrmals	repeatedly
ernähren	feed; nurturing
Gleichgewicht	balance
stundenlang	for hours
Pension	pension, guesthouse
stattfinden	occur, take place
Jet	jet
blättern	browse
Premierminister	prime minister
sexuell	sexually; sexual
Tugend	virtue
quälen	torture
empfindlich	sensitive; delicately
demnächst	soon
möglichst	as possible
verklagen	sue
Wurzel	root
Vermittlung	mediation, exchange
schockieren	shock
erholen	recover
Segel	sail
Neugier	curiosity
Komitee	committee
abschneiden	cut off; trimming
Treibstoff	fuel
Jeep	jeep
Liga	league
absagen	cancel, refuse
Mahlzeit	meal
Mittler	mediator
Zwischenzeit	meantime
Klub	club
Same	seed
Erpressung	blackmail
Schwerkraft	gravity
national	national; nationally
Verschwendung	waste
unabhängig	independently; independent
Ehrenwort	word of honor
knöpfen	button
Duell	duel
abschalten	turn off
ausbrechen	break out
Bestimmung	determination, destiny
Pflicht	duty
Herrschaft	rule
vorwerfen	accuse
Masse	mass
befürchten	fear
ersparen	save
ungerecht	unjust; unjustly
büßen	pay for
Gitter	grid
Geste	gesture
spenden	donate
Assistent	assistant
Bräutigam	groom
Komödie	Comedy
Kasino	casino
Kommission	committee
abknallen	shoot (coll)
abgefahren	awesome (coll); worn
Produzent	producer
stillen	breastfeed; breastfeeding
gewaltig	enormous; mightily
Zeitalter	age, period
abschließen	lock, complete
benommen	numb; numbly
Pfote	paw
erzeugen	generate
zerbrechen	break
servieren	serve
kriminell	criminal; criminally
kratzen	scratch
flach	flat, shallow
unsterblich	immortal
Stipendium	scholarship
Wolke	cloud
Rippe	rib
Säufer	drunk (coll)
vergeuden	waste
arbeitslos	unemployed
beseitigen	eliminate
umkehren	reverse
Passwort	password
regelmäßig	regularly; regular
überzeugend	convincingly; convincing
Knabe	boy (CH)
Fahrkarte	ticket
abziehen	remove
ungut	bad, uncomfortable
Schmutz	dirt
unerträglich	unbearable; unbearably
kontaktieren	contact
aufgebracht	upset
verkleiden	disguise, dress up
durchführen	carry out
Begegnung	encounter
klarstellen	clarify
Bezahlung	payment
Herkunft	origin
Stiftung	foundation
Kenntnis	knowledge
elegant	elegant; stylishly
verursachen	cause severe.
Jazz	jazz
eiskalt	freezing
bezaubernd	charming; charmingly
hinrichten	execute
Tuch	cloth
leuchten	glow
Salon	salon
aufhängen	hang
Abzug	trigger
vertraulich	confidential; confidentially
Wald	forest
Mumie	mummy
Logik	logic
Kurve	bend, curve
erfassen	capture; conception
anstelle	instead of
Schwung	momentum
Pressekonferenz	press conference
Zoll	customs, inch
zart	tender, tenderly
Division	division
ausprobieren	try (out)
aufeinander	on each other
eindringen	invade; intrusion
final	final
starr	rigid, rigidly
Vortrag	lecture
Becher	cup
verhören	interrogate, mishear
unendlich	infinitely; infinite
außergewöhnlich	exceptional; exceptionally
abreisen	depart
basieren	be based
ringen	wrestle, struggle
leugnen	deny, denial
Techniker	technician
sinken	sink
Glückspilz	lucky guy (coll)
Lebensmittel	food
Flut	flood, high tide
ängstlich	scared; fearfully
einatmen	inhale; inhaling
anschließen	connect
Effekt	effect
Peitsche	whip
Abreise	departure
jammern	complain
evakuieren	evacuate
vereinbart	agreed, appointed
überwinden	overcome
Abkürzung	abbreviation, shortcut
Kampagne	campaign
Beileid	condolence
herhören	pay attention
modeln	model (coll); modeling
Kommunikation	communication
geloben	vow
nachmittags	in the afternoon
Kapelle	chapel, band
Artillerie	artillery
Aufruhr	turmoil
produzieren	produce
Irak	Iraq
unerwartet	unexpectedly; unexpected
Juwel	jewel
Profit	profit
wiederhaben	have back
mittlerweile	meanwhile
gefährdet	endangered, vulnerable
Schrift	font, writing
Bewohner	resident
Stadion	stadium
knurren	growl
beneiden	envy
mitspielen	play along
kürzen	shorten
beichten	confess
stumm	mute; mutely
zuliebe	for sake
abgelaufen	expired, up
verbreitet	common
amüsant	amusing; amusingly
merkwürdig	peculiar; extraordinarily
Privatsphäre	privacy
verständlich	understandable; understandably
speziell	specifically; special
Hinterhalt	ambush
technisch	technically; technical
südlich	south; to the south of
Nutte	whore (coll)
hinzu	in addition
Ausgabe	edition
Horizont	horizon
Formel	formula
verschaffen	give
Siegel	seal
Illusion	illusion
anstrengend	exhausting
hacken	chop; job (AT)
einschließlich	including; inclusively
Russe	Russian
nachkommen	fulfill, comply with
Poesie	poetry
bescheiden	modest; modestly
Soße	sauce
langweilen	bore; get bored
zögern	hesitate; hesitation
unterzeichnen	sign
anbringen	apply
entsprechend	according to; corresponding
aufgelöst	upset
Birne	pear, bulb
Stützpunkt	base
Erfüllung	fulfillment
auflösen	dissolve, resolve
Anwesen	estate
erbärmlich	pathetic; pitifully
wertlos	worthless; worthlessly
kleiden	dress
Schwindler	fraud
schwingen	swing
angemessen	appropriate; suitably
zutiefst	deeply
Anzug	suit
gemäß	according to; appropriate
Fotograf	photographer
einbrechen	break in
heil	unhurt; salvation
männlich	male, masculine
Attentäter	assassin
Single	single; single record; (tennis) single
seither	since then
zerreißen	tear (up)
sorgfältig	careful; meticulously
verweigern	refuse
Sequenz	sequence
durchkommen	come through
tragisch	tragic; tragically
unverzüglich	prompt; promptly
schalten	switch
zueinander	to each other
entwerfen	design
gedenken	commemorate, commemoration
Video	video
Nagel	nail
Morgengrauen	dawn
ursprünglich	originally; original
Arena	arena
Parade	parade
Chor	choir
Südamerika	South America
dreißig	thirty
auswendig	by heart
Fingerabdruck	fingerprint
Vereinbarung	agreement
Abkommen	agreement, deviate
Durchsuchungsbefehl	(search) warrant
zugleich	at the same time
Überwachung	supervision
emotional	emotional; emotionally
fünfzig	fifty
misstrauisch	warily; wary
auslöschen	extinguish; extinction
Rahmen	frame
Streichholz	match(stick)
Tresor	safe
anstehen	stand in line
Zeitmaschine	time machine
Zusammenarbeit	cooperation
besagen	indicate
gesammelt	collected, collective
Hörer	receiver, listener
teilnehmen	participate
Käufer	buyer
Eichhörnchen	squirrel
intensiv	intense; intensely
automatisch	automatically; automatic
behindert	disabled
entsetzlich	terrible; terribly
Retter	savior
Limonade	lemonade
gebildet	cultured, produced
Anker	anchor
paranoid	paranoid
Bestätigung	confirmation
infizieren	infect
Sicherheitsdienst	security
Diagnose	diagnosis
Wirt	host, landlord
ausführen	implement; performing
beraten	advise; consult
nördlich	north
lahm	lame; lamely
Plastik	plastic, sculpture
angewiesen	dependent
Picknick	picnic
überraschend	surprising; surprisingly
Lamm	lamb
erraten	guess
aufschreiben	write down
Hintertür	back door
verstorben	deceased
Tomate	tomato
investieren	invest
Übertragung	transmitting
Zeichnung	drawing
Bildung	education, formation
Spaghetti	spaghetti
Volltreffer	bull's eye
freilassen	set free
quasi	practically
einmischen	blend into, interfere
Fach	subject, compartment
Anfänger	beginner
Geige	violin
Christ	Christian
Nonne	nun
boomen	boom
Band	band; ribbon; volume
Priorität	priority
(he)rausschmeißen	throw out
Truhe	chest
Erziehung	education, upbringing
Lagerhaus	warehouse
zuschlagen	slam, strike
verfehlt	inappropriate, missed
Wanne	bathtub
Ameise	ant
verletzt	injured
aktivieren	activate
stehenbleiben	stop
verreisen	travel
Notruf	distress call
meinerseits	for my part
Herzschlag	heartbeat
Rucksack	backpack
hiermit	hereby
Wal	whale
munter	cheerful; cheerfully
Vorrat	supply
Fälschung	forgery
reinigen	clean
Feld	field
militärisch	military
hierfür	for this
erstaunt	amazed; in amazement
Bestellung	order
Feierabend	quitting time
prächtig	splendid; magnificently
anheuern	hire (coll)
anderthalb	one and a half
allergisch	allergic; allergically
außerirdisch	alien
Dinosaurier	dinosaur
(he)rauswerfen	throw out
erschlagen	slay; slayed
Passagier	passenger
Sackgasse	dead end
scheitern	fail; failure
Patron	patron
quer	crosswise
sichtbar	visible; visibly
lähmen	paralyze
ablenken	distract
anzünden	light
kooperieren	cooperate
bereithalten	stand by
allmächtig	almighty; almightily
Routine	routine
geradezu	almost
zurückholen	retrieve
Exemplar	specimen
Welpe	puppy
abstellen	park, turn off
Organ	organ
süchtig	addicted
Ballon	balloon
zumachen	close (coll)
Munition	ammunition
Massaker	massacre
rauben	rob
Stier	bull
Apotheke	pharmacy
Laken	sheets; linen
sentimental	sentimental
vertraut	familiar; intimately
Busen	bosom
überstehen	survive
aggressiv	aggressive; aggressively
fünfzehn	fifteen
Niere	kidney
schwitzen	sweat
Beutel	bag
Materie	matter, substance
wegwerfen	throw away
jeglicher	every (fml)
foltern	torture
unfassbar	incomprehensible; incomprehensibly
umgehend	immediately; immediate
faszinieren	fascinate
drängen	pressure
Zauberei	magic
beschaffen	procure; constituted
hinterlassen	leave (behind)
stur	stubborn; obstinately
Mexiko	Mexico
verschonen	spare
Klima	climate
gewähren	grant
Panama	Panama; panama hat
Alter	age; dude (coll)
Berufung	vocation, appeal
Leder	leather
verängstigen	frighten
Scheißdreck	shit (coll)
Tumor	tumor
fortfahren	proceed
voneinander	on each other
Distanz	distance
geistig	mentally; spiritual
fürchterlich	terrible; terribly
Annahme	adoption, assumption
unauffällig	inconspicuous; unobtrusively
Jahreszeit	season
fällig	due
hindurch	through
Vizepräsident	vicepresident
wiederum	in turn, again
ehemalig	former
hold	lovely, fair (fml)
Badewanne	bathtub
verstoßen	contravene; outcast
Reinigung	cleaning
derzeit	currently
Kai	quay
edel	noble; nobly
Untergang	downfall
erforschen	explore
anvertrauen	entrust
absetzen	drop (off), sell
Limousine	limousine
Maßnahme	measure
durchhalten	hold out
Perle	pearl, bead
zukünftig	future; in future
Hingabe	devotion
gewalttätig	violent
verknallen	have a crush (coll)
körperlich	physically; physical
Wrack	wreck, wrecked
meiden	avoid
entwischen	escape
Poker	poker
verwundet	wounded
kauen	chew
Schlacht	battle
Summer	buzzer
Quittung	receipt
wesentlich	essential; considerably
Vase	vase
Weibchen	female
Weltraum	space
pink	pink
schlachten	slaughter
Akademie	academy
Bass	bass
letztens	the other day
blass	pale
bange	anxious
Hebel	lever
auftreiben	find (coll), raise
verleihen	lend
mittags	at noon
Orchester	orchestra
strahlen	shine
nahen	approach
liebend	loving; lovingly
Verwirrung	confusion,
Päckchen	parcel
Bedürfnis	need
fünfter	fifth
gruselig	creepy; creepily
Konzentration	concentration
dringen	insist, penetrate
Argument	argument
jüdisch	Jewish
Taxifahrer	taxi driver
Abwechslung	variety, change
sodass	so that
zurücktreten	step back
Bandit	bandit
Bewährung	parole
Sprichwort	proverb, saying
Schale	bowl, shell
mitgehen	go with
Aufseher	warden
zischen	hiss
fortsetzen	continue
unfähig	unable
wodurch	how
Autopsie	autopsy
Afghanistan	Afghanistan
markieren	mark
anfahren	approach, hit
arrogant	arrogant; arrogantly
bereden	talk about
Wachtmeister	sergeant (AT)
gefährden	endanger
sehnen	crave; yearning
Kaviar	caviar
lehnen	lean
Motto	slogan
vorübergehend	temporarily; temporary
Nickerchen	nap
Becken	basin; pelvis
Sahne	cream
einschalten	turn on
Überstunde	overtime
Adel	nobility
Flüssigkeit	liquid
zwo	two (coll)
Kreuzung	crossing
vorgestern	the day before yesterday
immerzu	always
verführen	seduce
Zauberer	wizard
Mühle	mill, grinder
Vorschlag	proposal
Umkreis	perimeter
drittens	thirdly
Sattel	saddle
Vorname	first name
ermitteln	determine
widmen	devote
Indianer	American Indian
Solo	solo
Zwischenfall	incident
entzückend	delightful; delightfully
ersticken	suffocate
gebieten	demand (fml)
Wurst	sausage
anhaben	wear
Auswirkung	impact
verwechseln	confuse
Inhalt	content
registrieren	register
Lieferwagen	van
Truthahn	turkey
Maulwurf	mole
programmieren	program
Ader	vein
Beleidigung	insult
wegfahren	drive away
Unterkunft	accommodation
Matratze	mattress
Schal	scarf, stale
hochgehen	go up; explode
Gipfel	summit
lecken	lick
grinsen	grin
Grube	pit
Sack	bag
Quartier	quarters, district
Schweizer	Swiss
einrichten	set up
Harmonie	harmony
vornehm	distinguished; nobly
vorsehen	plan
Komiker	comedian
wehen	blow
beugen	bend
Uhrzeit	time (of day)
Patrouille	patrol
winzig	tiny
Türklingel	doorbell
missbrauchen	abuse
Korrektur	correction
gestalten	shape
theoretisch	theoretically; theoretical
Beruhigungsmittel	sedative
geduldig	patient; patiently
wider	against
trösten	console
Flanke	flank
Ratschlag	advice
pflegen	maintain, nurse
streben	strive
Seide	silk
Geschäftsführer	managing director
lebenslänglich	lifelong; for life
Dosis	dose
göttlich	divine; divinely
manipulieren	manipulate
Galerie	gallery
Zwiebel	onion
hinbringen	bring
Umgang	handling
bedrücken	depress
Umarmung	hug
Prostituierte	prostitute
Schimmer	gleam, idea (coll)
gefällig	pleasing; accommodatingly
Wachmann	security guard
(he)rumlaufen	walk around
auffinden	find
Schlaganfall	stroke
schmerzhaft	painfully; painful
gottverdammt	goddamn (coll)
Bildschirm	screen
Schnurrbart	mustache
kindisch	childish; childishly
pusten	blow (coll)
prostituieren	prostitute
umzingeln	surround
Gorilla	gorilla
gleichgültig	indifferent; nonchalantly
unverschämt	outrageous; outrageously
ausgefallen	fancy
stopfen	plug
abscheulich	hideous; hideously
Puste	puff (coll)
ducken	duck, humiliate
Auszeichnung	award
kommunizieren	communicate
Stückchen	(small) piece
anordnen	arrange
Phantom	ghost
zugreifen	access
Qual	torment
Gier	greed
Verfolgung	persecution
zusammenhalten	stick together
Visier	visor
enorm	enormous; enormously
Premiere	premiere
Vorwand	excuse
Geschöpf	creature
Hospital	hospital
ungeduldig	impatient; eagerly
verfügbar	available
schütteln	shake
Ausstellung	exhibition
wischen	wipe
geübt	trained, proficient
abreißen	demolish
ausnutzen	exploit
Block	block
Funktion	function
durchknallen	go crazy (coll)
Kaplan	chaplain
Schüssel	bowl
ausleihen	borrow, lend
Verlobung	engagement
Schöpfer	creator
Sonnenlicht	sunlight
Haushalt	household
Cocktail	cocktail
überflüssig	superfluous; gratuitously
Vernichtung	destruction
Hexe	witch
Nord	north
Kreide	chalk
Notaufnahme	emergency room
Magazin	magazine
Vögelchen	birdie
Wildnis	wilderness
Pariser	Parisian
elektrisch	electric; electrically
Galgen	gallows
Pudding	pudding
keinesfalls	by no means
pumpen	pump
schwindeln	cheat
taugen	be good
ausreichend	sufficient; sufficiently
Regenbogen	rainbow
zerschlagen	smash; shattered
Schwindel	fraud
Budget	budget
herab	down
Gegenstand	object
belegt	busy, occupied
Geschwister	siblings
Küstenwache	coast guard
Terrorismus	terrorism
aufwärmen	warm (up)
Ernte	harvest
relativ	relative; relatively
rechtfertigen	justify; clear oneself
Expedition	expedition
daraufhin	thereupon
saufen	booze (coll)
verflixt	darn; confoundedly
Bruch	break
ansprechen	address
murmeln	murmur
Überzeugung	conviction
Änderung	change
Durchbruch	breakthrough
Bestrafung	punishment
durstig	thirsty; thirstily
verkünden	announce
bemerkenswert	remarkably; remarkable
schweben	float
allgemein	generally; general
Märtyrer	martyr
Pullover	sweater
reiben	rub
Hotelzimmer	hotel room
eitern	fester
flehen	plead
Formular	form
Profil	profile
Wechselgeld	change
dahinten	back there
aufziehen	raise, draw up
Wange	cheek
Gruß	greeting
Lift	lift
unbewaffnet	unarmed
lenken	direct
Examen	exam
anhängen	attach
Resultat	result
Träger	carrier
Taktik	tactic
Mais	corn
inklusive	including; inclusively
inwiefern	how
Terror	terror
krass	crass; crassly
darstellen	represent
träge	sluggish; sluggishly
gutmachen	atone, make right
loslegen	get going (coll)
niedrig	low; lowly
Klassiker	classic
Vorbereitung	preparation
Geschirr	dishes
sichten	sight
fortgehen	leave
Sekretär	secretary
restlich	remaining
Drohung	threat
Bund	association, bunch
Erleichterung	relief
Befragung	survey
angeben	specify
(he)rauslassen	let out
Anrufbeantworter	answering machine
Mitbewohner	roommate
Fakt	fact
verschlucken	swallow
Rand	edge
einschlagen	strike
Schlucht	ravine
überschnappen	go nuts (coll)
Kavallerie	cavalry
bedauerlich	regrettable, unfortunately
Putzfrau	cleaning lady
sensibel	sensitive, sensitively
kneten	knead
gleichfalls	also
benennen	designate
Bengel	rascal (coll)
Schwimmer	swimmer
Pier	jetty
Exil	exile
wimmern	whimper; whimpering
Ironie	irony
Karate	karate
Entlassung	dismissal
Haftbefehl	warrant
Senior	senior
Reservierung	reservation
Berührung	touching
verwirrend	confusing
Trupp	squad
ächzen	grunt; grunting
Überrest	remains
Granate	grenade
Chirurg	surgeon
ansagen	announce; announcement
Zeugenstand	(witness) stand
untergehen	go down
Garantie	guarantee
zukommen	get; befit
nachfragen	ask
Befreiung	liberation
inspirieren	inspire
huch	yikes
Orgasmus	orgasm
aufsetzen	put on, set up; sit down
samt	including; velvet
Maß	measure; mass
Nachfrage	demand
abdrücken	shoot
Anflug	approach, hint
versenken	sink; immerse
Gans	goose
erpressen	blackmail
gewagt	daring, daringly
Dämmerung	dawn
Durchsage	announcement
Drittel	third
Kondom	condom
zurückhalten	hold back
Beschützer	protector
feindlich	hostile, adversely
berauben	rob
erstatten	refund
wegtreten	be dismissed, step away
Sprit	gas (coll), booze (coll)
durchschauen	see through
Gastgeber	host
sofern	provided
gierig	greedy; greedily
Beobachtung	observation
ermöglichen	enable
zudem	moreover
Luder	slut (coll)
Arrest	detention
Gespenst	ghost
vollbringen	accomplish
Erkältung	cold
Metro	metro
Alliierter	ally
Mythos	myth
Inspiration	inspiration
bedacht	careful; carefully; deliberation
Schleier	veil, shroud
Eule	owl
Mitteilung	communication, message
Reserve	reserve
Graf	count, graph
töricht	foolish; foolishly
Entwurf	draft
Austausch	exchange
abfahren	leave
Langeweile	boredom
beziehen	obtain, refer
Empfehlung	recommendation
inmitten	amid
Klatsch	gossip
magisch	magical, magically
Wahl	choice, election
Mieter	renter
Gärtner	gardener
abhängen	depend, hang out (coll)
Abschlussball	prom
klatschen	gossip
Unterhose	underpants
schleppen	drag
Privileg	privilege
anmachen	turn on, hit on (coll)
Verpflichtung	commitment, obligation
Nachname	last name
angespannt	tense; tensely
günstig	favorable, cheap; favorably
streicheln	stroke
deuten	indicate
erwecken	arouse
weigern	refuse
Schleppe	train
Kaliber	caliber
realistisch	realistic, realistically
aneinander	together
genehmigen	approve
Pulver	powder
Hummer	lobster
verdecken	cover, hide
unterschiedlich	different; differently
finanzieren	finance
sozial	social; socially
Design	design
wahrlich	truly
wahrhaftig	true; truly
vergeblich	vain; in vain
Aufruf	appeal
Schreck	scare
Todesstrafe	death penalty
Strenge	rigor
erkälten	catch a cold
zwecklos	futile; uselessly
erleiden	suffer
Heizung	heating
Vermutung	presumption
gleichen	resemble, equal
dergleichen	similar, suchlike
Instrument	instrument
Jackett	jacket
rühren	stir
erschüttern	shake, shatter
(he)rauskriegen	find out (coll)
versterben	die
Aschenbecher	ashtray
Brötchen	bun
Joint	joint
Hülle	case
überbringen	deliver
römisch	Roman
Schaufel	shovel
herauf	up
Wohlstand	prosperity
anderswo	elsewhere
Massage	massage
Bankrott	bankruptcy; bankrupt
hüllen	wrap
aufwecken	wake
außerordentlich	extraordinarily; extraordinary
Dorf	village
Parfum	perfume
rächen	avenge
Verstärkung	reinforcement
überdenken	rethink
vermieten	rent
Brei	pulp
Attacke	attack
Bataillon	battalion
vierzig	forty
abstürzen	crash, fall
baden	bathe
erstechen	stab (to death)
verspäten	delay; be late
Romantik	romance
Brücke	bridge
bedrohen	threaten
Mikrofon	microphone
hereinkommen	come in
loyal	loyal; loyally
Anstalt	institution
Portier	porter
Einwand	objection
Enttäuschung	disappointment
Scheinwerfer	headlight
Gewebe	tissue
Tierarzt	vet
Traurigkeit	sadness
Haustür	front door
erlangen	gain
vorsprechen	audition
Bluse	blouse
Generator	generator
Monitor	monitor
dreizehn	thirteen
Sperma	sperm
hinkriegen	menage (coll)
tagelang	for days, daylong
Tango	tango
Damm	dam
Streik	strike
Bemühung	effort
derart	such
Packung	package
zusätzlich	additionally; additional
einlegen	insert; loading
Erfinder	inventor
exklusiv	exclusive, exclusively
verstärken	strengthen
Hai	shark
Kessel	kettle
scheußlich	hideous; hideously
Todesursache	cause of death
abschießen	shoot down
Großteil	majority
altmodisch	oldfashioned
bevorzugen	prefer
Neger	Negro (coll)
zärtlich	tender; tenderly
Heilmittel	cure
innerlich	internal; internally
dulden	tolerate
verbannen	banish
vollenden	complete
beruhen	be based
aufbewahren	keep
sonntags	on Sundays
professionell	professional, professionally
Korridor	corridor
Demonstration	demonstration
Falte	wrinkle
verständig	understanding; maturely
Telefonzelle	phone booth
Helfer	helper
Eröffnung	opening
unruhig	restless; uneasily
vage	vague; vaguely
Schmetterling	butterfly
bewaffnet	armed
Ekel	disgust; disgusting (coll)
Schicksal	fate
falten	fold
idiotisch	idiotic; idiotically
beerdigen	bury
Ton	tone, clay
Schlamassel	mess (coll)
Männchen	male
Organismus	organism
paaren	pair
Nazi	Nazi
komplex	complex
pervers	perverted; perversely
ausweichen	avoid
anfühlen	touch, feel
schleichen	sneak
Partie	game
Erscheinung	appearance
erwachen	awaken
schmeicheln	flatter
äußere	outer
Feuerwehrmann	firefighter
Besetzung	occupation
anpassen	adjust
Wirbel	vortex, vertebra
Takt	stroke, tact
Häftling	prisoner
herumlaufen	walk around
Herzanfall	heart attack
letztlich	ultimately
Büffel	buffalo
belohnen	reward
Zündung	ignition
Anschluss	connection
Base	base
Schenkel	thigh
Scharfschütze	sniper
Sonnenbrille	sunglasses
auslösen	trigger, release
Obhut	care (fml)
Verwalter	administrator, manager
gerissen	sly (coll)
eingebildet	conceited; smugly
einpacken	wrap, pack
trauern	mourn, grieve
Meisterwerk	masterpiece
Armband	bracelet
Beschwerde	complaint
Hauch	whiff
glücklicherweise	fortunately
finanziell	financially; financial
gönnen	grant; indulge
bewirken	cause
Bekanntschaft	acquaintance
ärgerlich	annoying, angry; irritatingly
(he)reinfallen	fall for (coll)
Pony	bangs; pony
rutschen	slip, slide
Zitat	quote
Amerikaner	American
aufsuchen	see, find
jucken	itch
auserwählen	choose
Ungar	Hungarian
Ermordung	murder
einfangen	capture, get
teilweise	partly
hinreißend	gorgeous; adorably
Bemerkung	remark
tätig	active
Streifenwagen	patrol car
Anordnung	arrangement
vermitteln	convey, give
anrühren	touch
verdrehen	twist
unzählig	countless; innumerably
eingreifen	intervene
versteckt	hidden; covertly
Chinese	Chinese
absehen	predict
Kandidat	candidate
Schurke	villain
kopieren	copy
Aufsatz	essay
Reinheit	purity
Lücke	gap
chemisch	chemical; chemically
Kardinal	cardinal
sechster	sixth
abweisen	reject
global	global; globally
Syndrom	syndrome
Evakuierung	evacuation
flüchten	escape
Versuch	attempt
Justiz	justice
Erlösung	salvation
hinab	down
Geiger	violinist
Schöpfung	creation
stürmen	storm
ausliefern	deliver, extradite
Unteroffizier	sergeant
Deckel	lid
endlos	endless; endlessly
vielmehr	rather, just
Arabien	Arabia
wissenschaftlich	scientific; academically
verschweigen	conceal
Bücherei	library
Gefangenschaft	captivity
Sonde	probe
zustoßen	happen to
ernennen	appoint
Luftwaffe	air force
rührend	touching
hiervon	thereof
Business	business
Türkei	Turkey
Ski	ski
Notwehr	selfdefense
vermisst	missing, lost
Aufsicht	supervision
kleben	glue, stick
Elektrizität	electricity
Sauce	sauce
Leichnam	body, corpse
Alarmstufe	alert level
ungestört	undisturbed
begabt	gifted
Gebieter	master (fml)
sonderbar	weird; weirdly
unterschätzen	underestimate
predigen	preach
Rezeption	reception
schneien	snow
plagen	plague
einmalig	unique; uniquely
Glückstag	lucky day
Kooperation	cooperation
Automobil	automobile
intakt	intact
Papagei	parrot
Tonne	ton
Buchhaltung	accounting
Schlauch	tube
abfeuern	fire
Auszeit	time off, timeout
kritisch	critical; critically
Veranstaltung	event
jugendlich	youthful
Tournee	tour
lautlos	silent; silently
piepsen	beep; beeping
Kick	kick
Strick	rope
veranstalten	organize, hold
ausstatten	equip, provide
schonen	spare; take it easy
gefälscht	forged
Teich	pond
einholen	obtain, catch up
verwirren	confuse
Arbeitszimmer	study
ähneln	be similar
Basketball	basketball
bearbeiten	edit, process
niederschlagen	knock down; be reflected
spontan	spontaneously; spontaneous
bitter	bitter, bitterly
kassieren	collect
Niete	loser (coll), rivet
westlich	west
Sauerei	mess
Angewohnheit	habit
Berechnung	calculation, charge
Prophezeiung	prophecy
beängstigend	daunting
fertigmachen	finish; get ready
Absturz	crash
Architekt	architect
Hort	haven (fml)
blühen	bloom
verwöhnen	spoil
Staffel	relay, season
errichten	establish
beklagen	complain
zäh	tough; tenaciously
entzücken	delight
Depression	depression
blutig	bloody
tippen	type
Zimmerservice	room service
passend	suitable; suitably
aufführen	perform, list
basta	period
Ablenkung	distraction
Nummernschild	license plate
Insekt	insect
Nuss	nut
Asyl	asylum
Datei	file
verdoppeln	double
Regal	shelf
Lump	rascal
Nachschub	supplies
benachrichtigen	notify
fleißig	hardworking; studiously
allerseits	everybody
Schließfach	locker
unglücklicherweise	unfortunately
Frost	frost
Konsul	consul
binden	bind
lästig	annoying; inconveniently
Enkelin	granddaughter
Klippe	cliff
hinzufügen	add
verbrauchen	consume
Wettkampf	competition
Lunch	lunch
Waffenstillstand	truce
schmelzen	melt
Grausamkeit	cruelty
Entschluss	decision
erben	inherit
Schweinefleisch	pork
Filmstar	movie star
überschreiten	exceed, cross
Angehörige	relative, member
verbünden	join forces
Geschick	skill, fate (fml)
verfügen	have available
hebräisch	Hebrew
Vereinigung	association
Region	region
bohren	drill
Diskette	(floppy) disk
Lebensunterhalt	livelihood, living
hierbei	in this connection
schalen	peel
Garde	guard
provozieren	provoke
reduzieren	reduce
Heimweg	way home
fix	fixed; quickly (coll)
belassen	leave
aufsteigen	climb
insbesondere	in particular
Fund	find, finding
Bedienung	operation, service
Frucht	fruit
bestechen	bribe
Komplize	accomplice
betrinken	get drunk
analysieren	analyze
einhalten	comply with
gedruckt	printed
Überdosis	overdose
speisen	dine
unentschieden	undecided, tie
Abgang	slope
talentiert	talented
bombardieren	bomb
beschleunigen	accelerate
Autoschlüssel	car key
Management	management
Rest	rest
buchstäblich	literally; literal
Täuschung	deception
Leichenschauhaus	morgue
Gummi	rubber
Zeugnis	certificate, testimony
Heilung	healing
Vergeltung	retribution
Pub	pub
vorfallen	happen to
Würfel	cube, dice
aufwärts	up
schriftlich	in writing; written
startklar	ready to go
Archiv	archive
Ära	era
Schauspiel	play
verstopfen	clog; congest
Tätowierung	tattoo
Standort	location
künstlich	artificially; artificial
selig	blessed
Kapital	capital
Wiener	from Vienna; wiener
Umhang	cloak
Raubüberfall	robbery
(he)reinlassen	let in
räuspern	clear one's throat
einführen	introduce
Dimension	dimension
geschlossen	closed
herb	tart
Studie	study
befördern	promote
einlassen	let in, admit
ansetzen	schedule
Verwendung	use
Metzger	butcher
aufgehen	rise
Neid	envy
Notarzt	emergency (doctor)
(he)rangehen	approach
willens	willing (fml)
borgen	lend, borrow
strömen	stream
Yen	yen
diskret	discrete; discreetly
Verwaltung	management
Defekt	defect; faulty
Spruch	saying
angeblich	allegedly; alleged
Meisterschaft	championship
Unsterblichkeit	immortality
sicherstellen	ensure
Substanz	substance
kippen	tilt
Territorium	territory
sichergehen	be sure
entfliehen	escape
begleichen	settle, pay
sündigen	sin
kaiserlich	imperial
betäuben	stun
Gabel	fork
abheben	take off
schlank	slim
schwindlig	dizzy
jeweils	at a time
Rauschen	noise; rustle
unwohl	unwell
Absatz	paragraph
(he)runterkommen	come down
Eskorte	escort
hinsehen	look
Portion	portion
schlicht	simple; unpretentiously
aufklären	clarify
Begehren	desire
Elefant	elephant
förmlich	formally; formal
Gehirn	brain
raffiniert	subtle; artfully
frieren	freeze
Heck	stern
stattgeben	grant
imstande	able
östlich	east; to the east
mitbekommen	get
Ermittler	investigator
Geschütz	gun
ausmessen	measure
Antenne	antenna
Kommando	command
Prophet	prophet
religiös	religious; religiously
Kappe	cap
Söldner	mercenary
verrecken	die (coll)
(he)rausbringen	release
Vorschuss	advance
alias	alias
beunruhigen	worry
Kategorie	category
bislang	so far
Forscher	researcher
kostenlos	free (of charge)
Romanze	romance
Misstrauen	distrust
klappern	rattle; rattling
Mordfall	murder case
ihretwegen	for her
Terrasse	terrace
Eitelkeit	vanity
Übergabe	handover, delivery
(he)reinziehen	get involved (coll)
effektiv	effective; effectively
antreiben	drive, power
Geldbeutel	wallet
Handbuch	manual
identisch	identical; identically
Sammler	collector
surfen	surf; surfing
Moschee	mosque
adoptieren	adopt
siebter	seventh
betrügen	deceive
herauskommen	come out
solide	solid; solidly
verachten	despise
gewissermaßen	virtually
zornig	furious; furiously
ansteckend	contagious
hingegen	on the other hand; however
viermal	four times
Dock	dock
hartnäckig	persistent; obstinately
gezielt	targeted; purposefully
Kuckuck	cuckoo
Krüppel	cripple (coll)
sympathisch	nice, nicely
Umfeld	environment
Terminal	terminal
Klan	clan
Level	level
(he)rumhängen	hang out (coll)
Neuanfang	fresh start
einbringen	introduce; introduction
schwindelig	dizzy; dizzily
loben	praise
machtlos	powerless; helplessly
verfallen	expire; expired
Aufführung	performance
Heimweh	homesickness
auslassen	omit
Leistung	performance
Riese	giant, whopper
dastehen	stand there
Verleger	publisher
Staunen	amazement, wonder
liebenswürdig	gracious; graciously
nachgeben	give in
beruhigend	soothing; reassuringly
ausgelassen	exuberant; exuberantly
profitieren	benefit
eindringlich	strongly; urgent
auswählen	select
hintereinander	in a row
verheimlichen	conceal
Streitkräfte	armed forces
Schmied	blacksmith
voraussetzen	assume, require
Transporter	van
verstreuen	scatter
Handvoll	handful
Spital	hospital
Schloss	lock, castle
Sekt	champagne
gießen	pour
unerhört	outrageous outrageously
Gesichtsausdruck	expression
geheimnisvoll	mysteriously; mysterious
Debatte	debate
wegrennen	run away
Erzbischof	archbishop
vorerst	for the time being
Potential	capability, potential
herschicken	send (over)
Entführer	kidnapper
Weihnachtsgeschenk	Christmas present
austauschen	exchange
Mandant	client
Gurt	belt
Lenkrad	(steering) wheel
präzise	precise; precisely
widersprechen	contradict
türkisch	Turkish
Quarterback	quarterback
Rumpf	hull
Gebot	bid, command
monatelang	for months
befassen	deal
unversehrt	intact
Trompete	trumpet
Einbildung	imagination
Komplikation	complication
zurichten	prepare, hurt
überwältigt	overwhelmed
reizen	irritate, provoke
Stiefmutter	stepmother
befriedigen	satisfy
Flüchtling	refugee
beschatten	tail, shade
öde	bleak; bleakly; wasteland
ungeschickt	clumsy; clumsily
korrigieren	correct
Desaster	disaster
draufgehen	get killed (coll)
jetzig	present
Südafrika	South Africa
transportieren	transport
Konzern	group, corporation
Reaktor	reactor
Alarmanlage	alarm
Einkaufszentrum	mall
ausflippen	flip (coll)
schräg	diagonally; diagonal
wegkommen	get away
Rubel	ruble
umkommen	die
stillhalten	stand still
Gegenleistung	consideration, return service
anstoßen	drink to, nudge
einstecken	insert
einschüchtern	intimidate
begrenzt	limited; terminally
Beleuchtung	lighting
Verlegenheit	embarrassment
bezeugen	testify, witness
Rennbahn	(race) track
notieren	note
Kalb	calf
Kurier	courier
weiterfahren	drive on
Formation	formation
klarmachen	make clear
griechisch	Greek
Atemzug	breath
schrauben	screw; spiral
Spot	commercial
Tresorraum	vault
Fax	fax
Jahrestag	anniversary
zurückzahlen	pay back
Flinte	shotgun
erfreuen	please; enjoy
saugen	suck
Strumpf	stocking
Fackel	torch
Option	option
grauenvoll	horrid; horridly
Amateur	amateur
höllisch	hellish; horribly
getrauen	dare
Einkommen	income
sofortig	instant
Missachtung	contempt
zuverlässig	reliable; reliably
vorläufig	provisionally; provisional
anstrengen	strain; try hard
beladen	load; loading
ausfüllen	fill
Vorurteil	prejudice
leidenschaftlich	passionate; passionately
Ferkel	piglet
Mehrheit	majority
Hähnchen	chicken
polieren	polish; polishing
farbig	colored
versiegeln	seal
moralisch	morally; moral
giftig	poisonous
Coup	coup
Syndikat	syndicate
vergießen	spill
Lebensform	form of life
Designer	designer
korrupt	corrupted
Standard	standard
erweitern	expand
(he)rumsitzen	sit around
Spitzname	nickname
spitz	pointed; tip (AT)
Quote	quota
besetzen	occupy, cast
zauberhaft	enchanting; enchantingly
rothaarig	redheaded
Hypothek	mortgage
Investition	investment
Offenbarung	revelation
geboren	born
beschränken	confine
Gegenmittel	antidote
verriegeln	latch
äußern	express
Haustier	pet
erfrieren	freeze to death
Gutachten	report
widersetzen	resist
Zulassung	approval
Maschinengewehr	machine gun
Fallschirm	parachute
europäisch	European
vornehmen	make, carry out
installieren	install
verüben	commit
Sicherung	fuse, securing
exzellent	excellent; excellently
These	thesis
anonym	anonymous; anonymously
Elite	elite
hüpfen	hop
Pulli	jumper (coll)
Ostern	Easter
Drehung	rotation
Norm	norm
ultimativ	ultimate; ultimately
Visitenkarte	business card
grillen	barbecue
fernhalten	keep away
Mordkommission	homicide (squad)
zunehmen	increase
Dänemark	Denmark
flirten	flirt
Hindernis	obstacle
Schwiegersohn	soninlaw
Strömung	flow
preisen	praise
vorhanden	available
herüber	over
Notizbuch	notebook
Unterschlupf	shelter
Pakt	pact
erhören	hear
zitieren	quote
buh	boo
anhand	based on
fördern	promote
verhexen	jinx
inne	aware (fml); within
Katalog	catalogue
zusammenbleiben	stay together
simpel	simple; simply
Beteiligung	participation
schnarchen	snore
Philosoph	philosopher
Ventil	valve
Brocken	chunk
wiedergeboren	reborn
stressen	stress (coll)
Wanze	bug
bündeln	bundle
Automat	machine
einbrocken	get in trouble (coll)
(he)raushalten	keep out of
wegbringen	take away
Plätzchen	spot; cookie
aufspüren	detect
befestigen	attach, secure
Menü	menu
trocknen	dry
zurückbleiben	remain
verheiratet	married
Bereitschaft	willingness
vortreten	step forward
betonen	emphasize
primitiv	primitive; primitively
angucken	look at (coll)
Casanova	lover boy
abstoßend	repulsive; repulsively
zweieinhalb	two and a half
Lotto	lottery
Parasit	parasite
unklar	unclear; obscurely
Feiertag	holiday
umfallen	fall down, capitulate (coll)
Wasserfall	waterfall
texten	text
fies	nasty (coll)
Korn	grain
kurzfristig	short; quickly
Gunst	favor
Schwangerschaft	pregnancy
Kakerlak	cockroach
Lichtgeschwindigkeit	light speed
Astronaut	astronaut
Erwärmung	warming
Nicaragua	Nicaragua
zuschauen	watch
Spritztour	joy ride (coll)
scheu	shy; awe
vermischen	mingle
Nervensäge	nag (coll)
gequält	haunted
Skorpion	skorpion
Kanzlei	office
vormachen	fool; show
stillstehen	stand still
Bankräuber	bank robber
auskommen	get along
Haushalter	housekeeper
Genuss	enjoyment
betrübt	saddened; sadly
hochziehen	pull up
geradewegs	straight
gehorsam	obedient; obedience
befugen	authorize
Freundlichkeit	kindness
mitkriegen	realize (coll)
ausrutschen	slip
einsehen	see, recognize
fetzen	shred
Hinterkopf	back of the head
Pärchen	couple
davonkommen	get away
Schacht	shaft, well
belasten	burden
suspendieren	suspend
Gewahrsam	custody
zwitschern	chirp; tweet
ausbuchen	book out, write off
Ausfahrt	exit, drive
Krankenstation	infirmary
einsatzbereit	operational
polnisch	Polish
Punk	punk
eintragen	enter
Initiative	initiative
Dasein	existence
Träumer	dreamer
Glücksbringer	lucky charm
beinhalten	contain
ausschließlich	exclusively; exclusive
unmoralisch	immoral; immorally
booten	boot
einliefern	hospitalize
Beule	bump
stolpern	stumble
gegeneinander	against each other
Kolumne	column
wohlauf	well
Handwerk	craft
abkriegen	get (coll)
Behinderung	disability, obstruction
aufsehen	look up; sensation
Anzahlung	deposit
Auskunft	information
ausfallen	fail, fall out
Aufklärung	enlightenment, education
Psychopath	psychopath
zerfetzen	shred
Hexerei	witchcraft
Vulkan	volcano
Anschein	appearance
vorbeischauen	stop by
ablaufen	run, expire
Verzögerung	delay
Entsetzen	horror, appall
Gleis	track, platform
unterdrücken	suppress
tausendmal	a thousand times
Ochse	ox
Chauffeur	chauffeur
Angeber	showoff
Krokodil	crocodile
schmieren	grease
schnellstens	as soon as possible
Riegel	latch
Flora	flora
unverändert	unchanged
universal	universal; universally
Unterbrechung	interruption
düster	gloomy; gloomily
beschlagnahmen	confiscate
finster	sinister; gloomily
kritisieren	criticize
ausstellen	exhibit, issue
Ausschuss	committee
anmelden	register
Vormittag	morning
Krug	jug
frustrieren	frustrate
Konvoi	convoy
unvorstellbar	incredible; incredibly
schwellen	swell
Inder	Indian
kreuzen	cross
Propaganda	propaganda
Übergang	transition
Serienmörder	serial killer
lesbisch	lesbian
Hockey	hockey
Hausfrau	housewife
klarkommen	get along (coll)
erreichbar	accessible
Körperverletzung	assault
wählerisch	picky
verantworten	answer (for)
abhören	eavesdrop; eavesdropping
Engagement	commitment
Glücksspiel	gambling
versäumen	miss, fail
Großbritannien	Great Britain
rucken	jolt
verschütten	spill
erstmals	first
aufteilen	split (up)
voreilig	premature; prematurely
Übung	practice
respektlos	disrespectful; disrespectfully
heimgehen	go home
Kusine	cousin
Rebellion	rebellion
hinnehmen	accept, put up with
losfahren	set off
Spieß	skewer
katholisch	Catholic
Anschuldigung	accusation
Architektur	architecture
Schwimmbad	swimming pool
Ketchup	ketchup
durchschneiden	cut through
Verachtung	contempt
Seufzer	sigh
Dorfbewohner	villager
anschnallen	buckle (up)
Kreislauf	circulation
furzen	fart (coll)
Kolonie	colony
sticken	embroider; embroidery
Sichtkontakt	visual
berechnen	calculate, charge
beschämen	embarrass
Unterdrückung	repression
auferstehen	(a)rise
Kündigung	dismissal, resignation
Abgeordnete	representative
Pinsel	brush
ausnehmen	exclude
ausdrücklich	expressly; express
gebühren	be due
unbemerkt	unnoticed
erstellen	create
Brigade	brigade
Gips	(plaster) cast
Abendbrot	supper
Schick	style; chic
Teleskop	telescope
Kröte	toad
missverstehen	misunderstand
demütigen	humiliate
Schiedsrichter	referee
Kode	code
spätestens	at the latest
erforderlich	required, necessary
Revolver	revolver
Musical	musical
ausweisen	expel; identify
liebevoll	lovingly; loving
durchatmen	breathe
Perfektion	perfection
Taschentuch	handkerchief
Halluzination	hallucination
wiehern	whinny
Überprüfung	review
irgendwoher	from somewhere
bedeutungslos	meaningless
nahezu	almost
schubsen	nudge, push (coll)
Widerspruch	contradiction
säubern	clean
Antlitz	face (fml)
kostbar	precious; preciously
Walzer	waltz
Merkmal	feature
Schwiegervater	fatherinlaw
grundlos	groundless; unfoundedly
dranbleiben	hang on (coll)
nachschauen	look up
Maschinenraum	engine room
verfehlen	miss
mysteriös	mysterious; mysteriously
Präsentation	presentation
wachsam	alert; attentively
Lungenentzündung	pneumonia
Sanatorium	sanatorium
zerquetschen	crush
Unruhe	unrest
Urkunde	deed, document
Nachthemd	nightgown
Baumwolle	cotton
Trinker	drinker
undankbar	ungrateful; ungratefully
Jahrgang	year, vintage
abstimmen	vote
wörtlich	literally; literal
Hausarbeit	homework
mithalten	keep up
verärgern	annoy
durchbrechen	break
vertuschen	cover up
Insasse	inmate
Institution	institution
grunzen	grunt
aufreißen	rip
Krater	crater
deprimierend	depressing; depressingly
Kopfhörer	headphone
stauen	jam
Sensor	sensor
lutschen	suck
massieren	massage
Fürsorge	care
Untertan	subject
mild	mild; softly
währenddessen	meanwhile
Befehlshaber	commander
unterhalb	below
auspacken	unpack
wahrhaft	truly; true
zusagen	accept, promise
gänzlich	completely, sheer
rückgängig	undone
platzieren	place
oberflächlich	superficial; superficially
roh	raw; roughly
Partnerschaft	partnership
Diskretion	discretion
Wäscherei	laundry
Quarantäne	quarantine
nimmer	never (AT)
Kleinstadt	(small) town
eineinhalb	one and a half
Aquarium	aquarium
Flöte	flute
Beweismaterial	evidence
Atombombe	atom bomb
zuteilen	assign
Masche	scam (coll)
Tau	dew; rope
kreischen	shriek
ironisch	ironic; ironically
Aufstellung	list
Erleuchtung	enlightenment
Urin	urine
genetisch	genetically; genetic
Hoden	testicle
weichen	yield, soak
Legion	legion
aufzeichnen	record, draw
heiter	cheerful; cheerfully
weitergeben	pass
Darbietung	performance
Oberin	matron
tauen	thaw
Fassade	facade
reservieren	reserve
Auktion	auction
Anteil	share
kaltblütig	coldblooded; coolly
übermitteln	convey
Aspekt	aspect
kränken	offend, hurt
Yacht	yacht
Zusammenleben	living together; coexist
Kralle	claw
(he)runtergehen	go down
Sträfling	convict
Hektar	hectare
ausschließen	rule out
gebrochen	broken; brokenly
Banane	banana
verjagen	scare off
Gewissheit	certainty
krallen	claw
hinstellen	put (down)
Verschluss	shutter
intern	internal; internally
Balance	balance
Initiale	initial
Zünder	detonator
verabscheuen	detest
brennend	burning; keenly
Heiligabend	Christmas Eve
Auftraggeber	client
Manöver	maneuver
Beweisstück	exhibit
Shampoo	shampoo
grauenhaft	atrocious; horrifically
Freak	freak
Ufo	UFO
Fledermaus	bat
improvisieren	improvise
Franzose	Frenchman
historisch	historical; historically
Taste	button
spülen	rinse
Tyrannei	tyranny
Partei	party
vorführen	show
festlegen	set
ankündigen	announce
Kopfweh	headache (coll)
verrotten	rot
veranlassen	arrange
Gänsehaut	goosebumps
Kristall	crystal(ware); crystal
stinkend	stinky
Zerstörer	destroyer
Besserung	improvement, recovery
speichern	save
Vitamin	vitamin
Abwehr	defense
originell	original; originally
erschreckend	frightening; alarmingly
Verbrennung	burn
himmlisch	heavenly
neuerdings	lately
Hausarrest	house arrest
verfassen	write, compile
einreichen	submit
aufessen	eat up
Entzug	withdrawal
bekloppt	daft (coll)
Schlips	tie (coll)
unbesiegbar	invincible
zusammenschlagen	beat up
elektronisch	electronic; electronically
Sucher	seeker
Bluff	bluff
Schuft	villain
hinkommen	get
artig	good
vierzehn	fourteen
blank	bare, broke (coll)
abbekommen	get
Anliegen	concern; be in contact
ehrgeizig	ambitious; ambitiously
pflücken	pick
Temperament	temper
Ferngespräch	longdistance call
Weide	meadow, willow
Abfindung	compensation
Arroganz	arrogance
erlösen	redeem
Süd	south
höchstpersönlich	personally
Genie	genius
gemischt	mixed
vertauschen	exchange
Kürbis	pumpkin
Durchreise	transit
Ostküste	east coast
abbiegen	turn
verschlafen	sleepy; oversleep; sleepily
Teilchen	particle
neigen	incline
Park	park
kitzeln	tickle
pur	pure, neat
zurückfahren	go back
Krabbe	crab
Zivilist	civilian
Einfahrt	driveway
Vorspiel	foreplay
stationieren	deploy
wochenlang	for weeks; weeklong
einbauen	install
Sauna	sauna
Föderation	federation
hingehören	belong (coll)
einfrieren	freeze
Wohlergehen	welfare
verlockend	tempting; temptingly
hinfallen	fall (down)
aufschlitzen	slit
erlaubt	allowed
geschweige	let alone
Umweg	detour
abwerfen	discard
Melone	melon
poltern	rumble; cluttering
Razzia	(police) raid
Bewunderung	admiration
Meuterei	mutiny
Dilemma	dilemma
tabu	taboo
beitreten	join
Bescheidenheit	modesty
Eiche	oak
List	ruse
bessern	do better
Salami	salami
versehentlich	inadvertently; inadvertent
mittendrin	in the middle
Gag	joke
verarbeiten	process
rankommen	get
ausrasten	snap (coll)
Campus	campus
Symptom	symptom
Waise	orphan
Palästina	Palestine
Umlaufbahn	orbit
physisch	physically; physical
anwenden	apply, operate
steigern	increase
Erbse	pea
Nebenwirkung	side effect
Ausgangssperre	curfew
ineinander	into each other
kommend	next
meilenweit	for miles
optimistisch	optimistic; optimistically
entscheidend	crucial; conclusively
Skulptur	sculpture
beschießen	fire
Schaukel	swing
weitaus	far, much
abgehen	leave; departure
schmuggeln	smuggle
erwürgen	strangle
abtreten	resign
Referenz	reference
überstürzen	rush
beitragen	contribute
andernfalls	otherwise
lindern	alleviate
mehrfach	multiple, several times
Rind	beef
Mitbürger	fellow citizen
Halsband	collar, necklace
Satz	sentence, set
spannungsgeladen	electric, tense
woraus	of what
Faktor	factor
vergrößern	increase
nacheinander	successively
Regenschirm	umbrella
Belastung	burden
saubermachen	clean
Alptraum	nightmare
gleiten	slide
Premier	Prime Minister; führend
Versorgung	supply, care
Dynastie	dynasty
biologisch	biological, biologically
mobil	mobile
freigeben	release
Klo	loo (coll)
Prototyp	prototype
Übereinstimmung	accordance, agreement
unterwerfen	subject; capitulate
Fingernagel	fingernail
ausatmen	exhale
Hüter	guardian
Bann	spell, ban
verzerren	distort
schaukeln	rock
Entschädigung	compensation
zahlreich	numerous
Leichenhalle	morgue
auslachen	laugh at
(he)rüberkommen	come over
Schwächling	weakling
zivilisiert	civilized
zuversichtlich	confident; confidently
Sensation	sensation
stiften	donate
Lok	engine
Pfeffer	pepper
Hirte	shepherd
zurechtkommen	manage
Habgier	greed
Knecht	servant
Krähe	crow
bergab	downhill
Schicht	layer, shift
anerkannt	recognized
verlängern	extend
Marschall	marshal
Beherrschung	control
verblüffend	striking; strikingly
chaotisch	chaotic, chaotically
Hypnose	hypnosis
Mittelalter	Middle Ages
sterblich	mortal
senken	reduce
Erdnussbutter	peanut butter
Spind	locker
überwältigend	overwhelming; overwhelmingly
Sonnensystem	solar system
ägyptisch	Egyptian
Kunde	customer
Schlaftablette	sleeping pill
Untergrund	underground
Schutzengel	guardian angel
bekennen	confess
Glied	limb
verzaubern	enchant
untreu	unfaithful; unfaithfully
vorziehen	prefer
geisteskrank	insane
Held	hero
verstört	distraught; haggardly
schaufeln	shovel
Abstimmung	vote
Protest	protest
jährlich	annual; annually
Wähler	voter
eliminieren	eliminate
schnüffeln	snoop
Stempel	seal, stamp
demonstrieren	demonstrate
flicken	mend
sogenannt	socalled
Brandstiftung	arson
faulen	rot
stempeln	stamp
weiterhelfen	help (along)
Kahn	boat
Netz	network, net
tierisch	animal, bestially
Bub	boy (AT)
Hautfarbe	skin color
depressiv	depressive; depressively
Schachmatt	checkmate
Verteidigungsminister	defense minister
Paranoia	paranoia
Filter	filter
Kopfgeldjäger	bounty hunter
Container	container
klicken	click
Bewährungshelfer	parole officer
bedeutend	significantly; significant
Anmarsch	coming, advance
Stapel	pile
entziehen	withdraw; escape
filtern	filter
flüchtig	volatile; briefly
Stellvertreter	deputy
zunichte	destroyed
züchten	breed, grow
erbauen	build
Berühmtheit	celebrity
stützen	support
Sympathie	sympathy
Spiegelbild	reflection
umstellen	adjust, surround
Sprung	jump
tüchtig	efficient; hard
verpfeifen	snitch (coll)
Haube	hood, cover
Aussterben	extinction, die out
zerbrechlich	fragile; fragilely
schockierend	shocking; shockingly
ehrenhaft	honorable; honorably
erleichtern	facilitate, relieve
Inschrift	inscription
leichtsinnig	reckless; recklessly
Kuppel	dome
annähernd	approximately; approximate
unberechenbar	unpredictable
Verstoß	violation
Port	port
Chirurgie	surgery
erbitten	solicit
schleifen	drag; grind
verschlingen	devour; twist
unterbringen	accommodate
folglich	therefore
Cabrio	convertible
Geburtstagsgeschenk	birthday present
Wirbelsäule	spine
Stadtrat	city council
zurückschicken	send back
Mutation	mutation
Präsenz	presence
Zutat	ingredient
Stacheldraht	barbed wire
eingeben	enter
ätzend	corrosive, lousy (coll)
blendend	marvelous; marvelously
Neigung	inclination
Alltag	everyday life
barfuß	barefoot
Behälter	container
krumm	crooked; crookedly
ausländisch	foreign
Zange	pliers
Skelett	skeleton
Bug	bow
vermehren	multiply
verlesen	read out; misread
Fernglas	binoculars
anstecken	infect; catch
nachgehen	pursue
vergebens	for nothing
Besorgnis	concern
Eiscreme	ice cream
durchbrennen	run away (coll); burn out
Terrain	terrain, territory
entzünden	ignite
Witwer	widower
Identifizierung	identification
Versetzung	transfer
verleugnen	deny
Reparatur	repair
erhängen	hang
mexikanisch	Mexican
Funkkontakt	radio contact
Waschmaschine	washing machine
Pakistan	Pakistan
Schaum	foam
Sponsor	sponsor
qualifizieren	qualify
Klarheit	clarity
definieren	define
jämmerlich	pathetic; miserably
Logo	logo; duh (coll)
Pasta	pasta
Abtreibung	abortion
Limit	limit
örtlich	locally; local
abseits	apart
Ausstattung	equipment
beieinander	together
Samstagabend	Saturday night
Ruine	ruin
auffällig	conspicuous; conspicuously
Loge	box, lodge
Zusammenbruch	collapse
Ablauf	procedure, expiration
Getue	fuss (coll)
abfinden	pay off; accept
brummen	mutter; hum
Makler	broker
miserabel	miserable; miserably
nicken	nod
Lehrer	teacher
sprachlos	speechless; speechlessly
durchqueren	cross
Hochzeitsgeschenk	wedding present
Mucks	*sound (coll)
erleuchten	light (up)
Weilchen	(little) while
anschließend	subsequently; subsequent
winken	wave
Wartezeit	waiting period
Fahndung	Manhunt
involvieren	to involve
enthüllen	reveal
immun	immune
verkraften	cope with
Alarmbereitschaft	Alert
Auftritt	Appearance
teils	part
Darm	Intestines
Aufschrei	Outcry
Nippel	nipple
repräsentieren	represent
armselig	pathetic
ordnen	organize
silbern	silver
Tyrann	bully
austricksen	trick
Vormund	Legal guardian
ungezogen	naughty
Ausführung	execution
Honorar	fee
einheimisch	indigenous
Glöckchen	Bells
verschlagen	devious
Pelz	fur
wegschicken	send away
erfrischend	refreshing
imitieren	imitate
gewaltsam	forcibly
Marionette	Puppet
Bestechung	bribery
vorenthalten	withheld
Regime	regime
Lachs	salmon
überholt	obsolete
Schotte	Bulkheads
Eintopf	stew
verpacken	pack
unbedeutend	insignificant
Gratulation	Congratulations
Befugnis	Authority
irritieren	irritate
einleiten	initiate
Farce	farce
ungeachtet	regardless
Turm	tower
breiten	broad
Unterhalt	Entertains
Blutvergießen	bloodshed
Bürgersteig	sidewalk
Getriebe	transmission
Wahrnehmung	perception
Einzelhaft	Solitary confinement
Schi	ski
Entschlossenheit	determination
Kopfgeld	Bounty
Verurteilung	Condemnation
homosexuell	homosexual
Prostitution	prostitution
dermaßen	so
Wohnheim	Dorm
Molekül	molecule
Serum	serum
ausüben	exercise
Aufwand	expenditure
hetzen	rush
seekrank	seasick
vereinbaren	arrange
abschlachten	slaughter
Pointe	Punchline
ungültig	invalid
abwärts	down
Bademantel	bathrobe
inszenieren	stage
machbar	makeable
kreativ	creative
Paragraph	paragraph
kosmisch	cosmic
Offizier	officer
beantragen	apply for
Neuseeland	New Zealand
buchstabieren	spell
zweihundert	two hundred
ehrenwert	honorable
Pickel	Pimples
nebeneinander	side by side
Bäcker	baker
Einklang	Unison
Büchse	rifle
mager	skinny
hocken	squat
verklemmen	jam
Rektor	Rector
anstarren	stare at
Lebensgefahr	risk of death
unverzeihlich	unforgivable
protestieren	protest
berechtigen	entitle
bestürzen	dismay
Alligator	alligator
Schwergewicht	Heavyweight
maximal	maximum
beispielsweise	for example
Barbier	barber
Stamm	tribe
bedauerlicherweise	regrettably
Lehrling	apprentice
Tanne	fir
Kran	crane
kreuzigen	crucify
teilhaben	participate
verhauen	beat up
lachend	laughing
großziehen	raise
Belästigung	harassment
kommunistisch	Communist
Kollektion	collection
aktuell	current
Selbstzerstörung	Selfdestruction
Vorgänger	predecessor
Schlagzeug	Drums
Öffnung	opening
Horde	horde
untereinander	among themselves
erwerben	acquire
bestreiten	deny
vernachlässigen	to neglect
Porträt	portrait
Pöbel	mob
spendieren	donate
hineingehen	go inside
Patsche	Slap
unvermeidlich	inevitable
lebhaft	lively
rücksichtslos	inconsiderate
anerkennen	recognize
durchdenken	think through
erzielen	achieve
Kamel	camel
Mäuschen	Mice
Karussell	carousel
andeuten	imply
bösartig	vicious
zehnmal	ten times
hastig	hastily
Erlöser	Redeemer
Elch	Moose
versöhnen	reconcile
hohl	hollow
abbrennen	burn down
sechzehn	sixteen
(he)rumstehen	(he) standing around
via	via
ausrüsten	equip
staatlich	state
Arche	ark
Mücke	mosquito
Verwandlung	transformation
Knaller	Blast
ununterbrochen	continuously
krepieren	to die
telefonisch	by phone
absitzen	dismount
abriegeln	cordon off
Wiederholung	Repetition
stottern	stutter
Landkarte	map
ungefährlich	harmless
Einigung	agreement
versperren	block
schmoren	stew
Demo	demo
sowjetisch	Soviet
Yoga	yoga
circa	approximately
israelisch	Israeli
Superheld	superhero
offensiv	offensive
zusammenbrechen	to collapse
zurücknehmen	take back
einjagen	chase in
Reklame	Advertising
hochkommen	getting high
Beil	ax
inoffiziell	unofficially
hergeben	give away
Playboy	playboy
Ruin	ruin
obendrein	on top of that
Trauung	wedding
launisch	moody
Treppenhaus	Stairwell
Anfall	Seizure
sausen	whiz
feierlich	solemnly
grässlich	horrible
Entspannung	Relaxation
rasten	rest
ergehen	endure
teuflisch	devilish
erniedrigen	humiliate
verstummen	fall silent
behindern	hinder
(he)rausnehmen	(remove
Versprechung	promise
Spesen	Expenses
geschmacklos	tasteless
Gruft	Crypt
achtzehn	eighteen
Internat	Boarding school
ausgraben	dig out
Angsthase	Scaredy rabbit
unpassend	inappropriate
Bündnis	alliance
Jackpot	jackpot
irrelevant	irrelevant
Migräne	migraine
Schmerzmittel	Painkiller
Drehort	Location
dreieinhalb	three and a half
Verlag	publishing company
abdrehen	turn off
Todesangst	Fear of death
Gebüsch	bushes
klammern	cling
ertappen	catch
einwandfrei	perfect
wiedererkennen	recognize
demnach	therefore
beschimpfen	insult
psychologisch	psychologically
Ausbilder	instructor
anklopfen	knock
insgeheim	secretly
Motor	engine
Klammer	Bracket
plädieren	to plead
abschlagen	knock off
abfangen	intercept
Schimpanse	chimpanzee
vergewissern	make sure
traben	trot
Unkraut	weed
berücksichtigen	consider
Hackfleisch	Minced meat
Waggon	wagon
Bäckerei	bakery
zelten	camp
Cello	cello
Automatik	Automatic
bergen	to recover
Favorit	favourite
ausschneiden	cut out
besichtigen	visit
vorbeigehen	pass
Anstrengung	effort
objektiv	lens
Zauberstab	Magic wand
Ausschnitt	Cutout
exzentrisch	eccentric
Baustelle	construction site
Eintrag	entry
traditionell	traditional
Kerker	Dungeon
Heft	notebook
grollen	rumble
autorisieren	authorize
Großeltern	Grandparents
Durchfall	diarrhea
spezial	special
fehlend	missing
Luftraum	airspace
Infektion	infection
anschlagen	attacks
Tresen	counter
rau	rough
zusammenkommen	getting together
bleich	pale
Begierde	desire
bedrohlich	threatening
ausverkaufen	sell out
Denkmal	monument
unmenschlich	inhuman
Blickwinkel	Point of view
Vers	verse
aufkommen	come up
futsch	gone
anmerken	to note
Ensemble	ensemble
Urteilsvermögen	discernment
Mithilfe	Help
Wichtigkeit	importance
Mast	mast
überreichen	hand over
offenbaren	reveal
pennen	sleep
Eintrittskarte	Admission ticket
Ansprache	speech
Hochstapler	Impostor
Wirtshaus	Public house
anführen	to lead
Spatz	sparrow
beleidigend	offensive
rasend	furious
Vorstellungskraft	Imagination
unangebracht	inappropriate
Verbesserung	improvement
zurückhaben	have back
Hinterzimmer	Back room
Abdruck	Imprint
Privilegium	Privilege
Venezuela	Venezuela
Puzzle	puzzle
beistehen	assist
Aufbau	construction
herausfordern	challenge
Showbusiness	show business
herausholen	get out
Schminke	Make up
intellektuell	intellectually
Rückstand	Residue
gescheit	clever
Rekrut	recruit
absperren	shut off
obdachlos	homeless
Ständer	Stand
Fachmann	Professional
Röhre	tube
nötigen	to necessitate
Torpedo	torpedo
schminken	makeup
Abwurf	Release
Finanzierung	financing
Falke	Falcon
Meister	master
Islam	Islam
Mordwaffe	Murder weapon
Vorstellungsgespräch	job interview
Allianz	alliance
Beihilfe	Aid
entschlüsseln	decrypt
vorbestraft	criminal record
(he)reinstecken	(he) stick in
blenden	dazzle
hörgeschädigt	hearing impaired
unfreundlich	unfriendly
eisern	iron
Schaffner	conductor
Zügel	Reins
missachten	disregard
Wahnvorstellung	Delusion
manuell	manually
zerschmettern	shatter
Polizeirevier	Police station
ausreichen	sufficient
ungelegen	inconvenient
entbehren	do without
allesamt	all of them
ausnahmsweise	exceptionally
zynisch	cynical
Beschluss	decision
Subjekt	subject
toben	romp
Kreuzfahrt	cruise
abergläubisch	superstitious
dröhnen	roar
spurlos	without a trace
Großzügigkeit	generosity
überallhin	everywhere
ungeeignet	not suitable
beheben	remedy
Gelübde	vow
verkrampfen	cramp
verbittert	bitter
heften	staple
zufälligerweise	coincidentally
standhalten	withstand
antik	antique
verschreiben	prescribe
Rasse	race
beibehalten	maintained
Qualität	quality
kaputtmachen	break something
Einschätzung	assessment
hunderttausend	hundred thousand
Zeitraum	Period
Vorstrafe	Criminal record
beklauen	steal
Ukraine	Ukraine
Brenner	burner
Demonstrant	Protester
Toaster	Toaster
Atom	atom
Finanzamt	Tax office
lauern	lurk
ertränken	drown
gewillt	willing
meckern	gripe
beisammen	together
Langweiler	Boring
kneifen	pinch
Jaguar	jaguar
Stinktier	skunk
Widerrede	Contradiction
Begnadigung	pardon
Zeitlang	For a while
spuken	haunt
Säule	pillar
Aufschub	Postponement
Ansatz	approach
Kerbe	score
zufügen	add
besteigen	climb
umhauen	blow away
durchsetzen	push through
Amnesie	amnesia
behüten	watch over
weiterziehen	move on
andersrum	the other way around
Redakteur	editor
Exekution	execution
Auffassung	Conception
beunruhigend	unsettling
Abrechnung	Billing
gegenwärtig	currently
Söhnchen	Son
Erschöpfung	exhaustion
irisch	Irish
auffliegen	blow up
irdisch	earthly
kooperativ	cooperative
aufheitern	cheer
dreifach	triple
Individuum	individual
unerreichbar	unreachable
Wiedergeburt	Rebirth
anheben	raise
Einzelgänger	loner
samstags	Saturdays
verringern	reduce
bowlen	bowl
Währung	currency
joggen	to jog
Klebeband	duct tape
Biker	Bikers
Bohrer	drill
Klon	clone
schwänzen	truant
Drucker	printer
Krönung	coronation
erfreulich	enjoyable
Schlitz	slot
Trümmer	debris
Henker	hangman
Taille	waist
Fass	barrel
geizig	stingy
eitel	vain
aufmuntern	cheer up
Zimmermädchen	Housekeeping
Buchhandlung	Bookstore
ebenbürtig	equal
Trophäe	trophy
ausbrennen	burn out
Abbild	image
Türglocke	Doorbell
verspielen	gamble away
Kanalisation	Sewerage
derartig	such
lausig	lousy
Karo	Diamonds
herzlos	heartless
ermutigen	encourage
Zweig	branch
Kaktus	cactus
Ankündigung	announcement
widerfahren	happened
Gemahl	husband
Vanille	vanilla
Gliedmaße	Limb
Stiel	stalk
Einfall	incidence
Infarkt	Infarct
Gage	Fee
Herstellung	Manufacturing
Handwerker	Craftsman
Todesfall	Death
unwürdig	unworthy
Schuster	Cobbler
Lagerraum	storage room
Match	match
beeinträchtigen	affect
Umfang	scope
zerlegen	disassemble
Messer	knife
Hochschule	University
Funkspruch	Radio message
Anleitung	manual
Garnele	shrimp
mittels	by means of
Eistee	Icetea
Kugelschreiber	pen
Leuchtturm	lighthouse
abwischen	wipe off
vortäuschen	to pretend
Spekulation	speculation
Hinterhof	backyard
Potenzial	potential
Reue	Repentance
bewohnen	occupancy
hasten	rush
Würgen	choke
sonderlich	particularly
zurückbekommen	get back
gnadenlos	merciless
verschwimmen	blur
Genesung	recovery
geehrt	honored
Schwarm	swarm
Generaldirektor	General Director
Brutalität	brutality
vorspielen	pretend
unanständig	indecent
Orchidee	orchid
Gläschen	Glass
eingeboren	native
Marmor	marble
Detektiv	detective
Tanzfläche	dance floor
Portugal	Portugal
Logbuch	logbook
überglücklich	overjoyed
Übernahme	takeover
unschlagbar	unbeatable
altern	aging
stellvertretend	representative
Engelchen	little angel
Geschäftsreise	Business trip
koscher	kosher
Schwertkämpfer	Swordsman
Rotwein	red wine
Kompromiss	Compromise
selbstsüchtig	selfish
Genugtuung	satisfaction
zertrümmern	smash
Lagerfeuer	Campfire
übertreffen	surpass
Damentoilette	Ladies room
Kork	cork
Ausblick	outlook
Ohrfeige	Slap
rammen	ram
Staatsbürger	citizen
lau	lukewarm
Schokoriegel	chocolate bar
konstruieren	to construct
Differenz	difference
Regenmantel	a raincoat
verständigen	communicate
auffressen	eat up
abwesend	absent
Prämie	bonus
Wendung	turn
erkundigen	inquire
Ersatzteil	Spare part
Zugführer	Platoon leader
Manipulation	manipulation
Expert	Expert
Vorsitz	Chair
Jüngling	youth
wahrnehmen	perceive
Staubsauger	vacuum cleaner
relevant	relevant
entschärfen	defuse
Morddezernat	Homicide Squad
Klopapier	toilet paper
trollen	troll
Gutschein	Voucher
Drogenhandel	Drug trafficking
Intensivstation	Intensive care unit
Delphin	dolphin
deaktivieren	deactivate
Lotterie	lottery
Verteidigungsministerium	Ministry of Defense
aufdringlich	intrusive
Elektriker	electrician
senil	senile
fallenlassen	drop
Säge	saw
Mahl	meal
Spott	Ridicule
Gefäß	vessel
kidnappen	kidnap
ausbreiten	spread
niesen	sneeze
Kommode	Dresser
verschenken	give away
Trance	trance
Auseinandersetzung	confrontation
untersagen	prohibit
Order	order
Fähnrich	Ensign
Mitgift	dowry
spotten	mock
Demütigung	humiliation
halbwegs	halfway
ungünstig	unfavorable
seinetwegen	because of him
überlegt	considered
Westküste	West Coast
betreffend	concerning
Trauzeuge	Best man
Prügelei	Brawl
Flugbahn	Trajectory
zubereiten	prepare
vollmachen	make full
ordern	order
Stellungnahme	opinion
Brille	glasses
gefangen	captured
neutral	neutral
massiv	solid
aufladen	charge
Banküberfall	Bank robbery
Lebensweise	Way of life
Heuchelei	hypocrisy
weit hergeholt	farfetched
krampfen	cramp
unmittelbar	right away
Flugblatt	Leaflet
Hinterwäldler	hillbilly
revolutionär	revolutionary
Glühbirne	Lightbulb
Salbe	ointment
Kante	Edge
ungesund	unhealthy
siamesisch	Siamese
Einrichtung	Facility
Epidemie	epidemic
Konstruktion	construction
Bruchteil	Fraction
nervig	annoying
Alphabet	alphabet
Zielperson	Target person
Maskottchen	mascot
Sexualität	sexuality
Junkie	junkie
Fete	Party
Auflösung	resolution
eigenhändig	by hand
verbluten	bleed to death
vorsingen	sing aloud
Topf	pot
überschätzen	overestimate
Tochter	daughter
verwüsten	devastate
Swimmingpool	Swimming pool
Bauchschmerz	Stomach ache
schlapp	limp
regelrecht	downright
brühen	brew
Balkan	Balkans
Wiederfinden	Recovery
schamlos	shameless
Komponist	composer
blamieren	to embarrass
zusammenreißen	stay calm
Karneval	carnival
Abteil	compartment
Hintereingang	Back entrance
ungläubig	incredulously
Flegel	Flail
unverletzt	unharmed
Laus	louse
Postbote	post man
augenblicklich	instantly
Denker	thinker
Befriedigung	satisfaction
abkühlen	cooling down
verständnisvoll	understanding
Vorahnung	Premonition
reimen	rhyme
glänzen	shine
verschicken	send
Herausforderer	challenger
fälschen	counterfeit
Motivation	motivation
Möwe	gull
recherchieren	do research
bewerben	apply
Wohnsitz	residence
steil	steep
traumhaft	gorgeous
grotesk	grotesque
(he)reinbringen	(he) bring in
furchtlos	fearless
taufen	to baptize
Fanatiker	fanatic
spezialisieren	specialize
Fusion	fusion
effizient	efficient
Vorort	On site
absteigen	descend
Weißwein	White wine
flattern	flutter
pensionieren	retire
hämmern	hammer
vorzüglich	excellent
auffordern	prompt
Duo	duo
Röntgen	roentgen
miauen	meow
durchfallen	fall through
größtenteils	Mostly
Erneuerung	renovation
Sicherheitschef	Security chief
Beweismittel	Evidence
Simulation	simulation
Umfrage	survey
versinken	sink in
straff	tight
Kavalier	cavalier
kühn	bold
Tätigkeit	activity
Geländer	railing
allemal	always
schnupfen	sniff
weiterarbeiten	keep working
Umlauf	Circulation
eintauschen	exchange
schäbig	shabby
zehntausend	ten thousand
Gehaltserhöhung	Raise
Einführung	introduction
einigen	some
verhelfen	help
wegbleiben	stay away
gleichmäßig	evenly
Hypothese	hypothesis
fromm	religious
verkuppeln	couple
verbeugen	bow down
überspringen	skip
bemitleiden	pity
Bauernhof	farm
Achterbahn	Roller coaster
Abmarsch	March off
Frist	Deadline
Residenz	residence
werben	advertise
mausetot	mouse dead
aufwühlen	stir up
Dünger	fertilizer
aufsitzen	sit up
einspringen	step in
Klumpen	Lump
lauschen	listen
sinnvoll	makes sense
übergehen	pass over
erlernen	learn
Zahlung	payment
vermöbeln	beat up
vorig	previous
untertauchen	submerge
erwidern	reply
Geheimagent	Secret agent
Jahrmarkt	Fair
zucken	pull out
Sarg	coffin
surren	whir
Photo	photo
poetisch	poetic
lebensmüde	tired of life
Marathon	marathon
Reflex	reflex
Durchmesser	diameter
Vermächtnis	legacy
Verzug	Default
sprühen	spray
dummerweise	stupidly
erbrechen	vomit
(he)rausziehen	(pull out
misshandeln	mistreat
Ablehnung	Rejection
Mayonnaise	mayonnaise
Struktur	structure
Rassist	racist
konfrontieren	confront
flippen	freak out
Plankton	plankton
Anpassung	Adaptation
Gästezimmer	Guest room
rummachen	to make out
Härte	hardness
Blasphemie	blasphemy
Einfluss	influence
bestehlen	steal from
lasten	burdens
Format	format
nobel	Nobel
vorrücken	advance
verdrängen	displace
Autodiebstahl	Car theft
standhaft	steadfast
grundsätzlich	basically
Injektion	injection
verschleppen	procrastinate
überblicken	overlook
Helm	helmet
strafbar	punishable
Taugenichts	Goodfornothing
nachweisen	prove
hintergehen	cheat
Arbeitslosigkeit	unemployment
Buchladen	Bookstore
anfertigen	make
bewältigen	deal with
Empfänger	receiver
Füller	ink pen
renovieren	renovate
Bahnsteig	platform
bewundernswert	admirable
überarbeiten	revise
vulgär	vulgar
wegziehen	move away
Adaption	Adaptation
aufrufen	call
ackern	plow
erneuern	renew
erläutern	explain
Blockade	blockade
Vagabund	rover
abliefern	deliver
Reisende	traveler
Maximum	maximum
vorliegen	are present
Schwätzer	Babbler
Erholung	recreation
Großstadt	Big city
heimfahren	drive home
spalten	columns
ablösen	peel off
ärztlich	medical
denkbar	conceivable
Hausmädchen	Housemaid
überweisen	transfer
erkunden	explore
Knöpfchen	Button
Mythologie	mythology
jaulen	howl
Schießpulver	Gunpowder
überziehen	overlay
Ohrring	Earring
verkörpern	embody
Puder	powder
undeutlich	indistinct
anschreien	shout at
Verdienst	Merit
dumpf	dull
Markierung	mark
instabil	unstable
Erniedrigung	Humiliation
Hebamme	midwife
Fegefeuer	purgatory
nachhause	home
Knochenmark	Bone marrow
Fehlfunktion	Malfunction
Sicherheitssystem	security system
Sabbat	Sabbath
Geldstrafe	Fine
befallen	infested
gestrig	yesterday
impulsiv	impulsive
Tramp	tramp
Zimmermann	Carpenter
sensationell	sensational
zusammenziehen	pull together
hinbekommen	get it
Pein	Pain
hiesig	local
Skala	scale
schmerzlos	painless
Ozean	ocean
hypnotisieren	hypnotize
brandneu	brand new
erstklassig	top notch
gesetzlich	legally
Beschäftigung	employment
Gasthaus	Inn
verseuchen	contaminate
divers	diverse
Pantoffel	slipper
Maniküre	manicure
fruchtbar	fruitful
glorreich	glorious
Verschwörer	Conspirators
Kreuzer	cruiser
Laufbahn	career
erlassen	enact
Schlussfolgerung	conclusion
bedecken	cover
mühsam	laborious
Mix	Mix
lüften	ventilate
bevorstehen	imminent
klimpern	strum
obgleich	although
Poet	poet
musikalisch	musically
aufbringen	raise
mixen	mix
wickeln	wrap
empor	up
wackeln	wiggle
Schriftrolle	Scroll
sagenhaft	fabulous
vielversprechend	very promising
unzuverlässig	unreliable
Piano	piano
Wappen	coat of arms
vernehmen	hear
zerstückeln	dismember
Schauplatz	Location
gefühllos	callous
ausschlafen	sleep in
Plasma	plasma
Scherbe	shard
Lösung	solution
dürr	dry
bisherig	previously
umschalten	switch
kopfüber	upside down
Fäulnis	Putrefaction
rumpeln	rumble
wandeln	walk
winseln	whine
Kapitalismus	capitalism
makellos	flawless
grundlegend	fundamental
Mundgeruch	Bad breath
Filmmaterial	Footage
Kassette	cassette
stabilisieren	stabilize
Kolumbien	Colombia
genaugenommen	strictly speaking
unterirdisch	underground
einschreiben	enroll
entehren	dishonor
Traktor	tractor
verblüffen	amaze
Stich	Sting
haufenweise	heaps of it
überlisten	outsmart
Punsch	Punch
Kabinett	cabinet
Gleichgültigkeit	indifference
flüssig	liquid
heikel	tricky
Entstehung	Emergence
Ausstrahlung	Charisma
künstlerisch	artistic
Vorgehensweise	method
ergreifend	poignant
subtil	subtle
Tausender	Thousands
rechtmäßig	lawful
vollziehen	carry out
Schlächter	Butcher
unvernünftig	unreasonable
Ade	Goodbye
Apfelkuchen	Apple Cake
christlich	Christian
Fundament	foundation
vorderer	front
plündern	plunder
Geleit	Escort
dreist	brazen
kapitulieren	capitulate
Behauptung	claim
unterhaltsam	entertaining
Filiale	branch
Handlanger	Henchman
bizarr	bizarre
Luftangriff	Air raid
Übersetzer	translator
Imbiss	snack
Offenheit	openness
Rippchen	Ribs
gläubig	believing
Kies	gravel
Stichwort	keyword
kahl	bald
durchstehen	get through
schlampig	sloppy
belegen	occupy
Abitur	High School
Posaune	trombone
Instruktion	instruction
schildern	describe
Spitzel	Spies
bezwingen	conquer
(he)rumliegen	(he) lying around
Kraut	herb
Karawane	caravan
ausstrecken	stretch out
Klischee	cliche
erlegen	shoot
spirituell	spiritually
hinhalten	hold out
aussichtslos	hopeless
Anziehungskraft	Attraction
gelehrt	taught
Genfer	Geneva
allerbeste	very best
Schwarzmarkt	Black market
Erschaffung	creation
Skalpell	scalpel
Anrufer	caller
psychiatrisch	psychiatric
ungarisch	Hungarian
Kelch	Chalice
verstümmeln	mutilate
unreif	immature
aufdecken	discover
Narkose	anesthesia
hineinziehen	involve
ledig	single
Kurzschluss	Short circuit
Gefolge	entourage
Kittel	Smock
indisch	Indian
Katholik	Catholic
Zensur	censorship
Schraubenzieher	screwdriver
Foul	foul
Krampf	Cramp
Balg	bellows
Jahrzehnt	decade
abartig	abnormal
Freiraum	free space
Artefakt	artifact
zugänglich	accessible
Gesundheitsamt	Health department
Miene	expression
Idol	idol
abstreiten	deny
beschmutzen	to pollute
Zugabe	Encore
stürmisch	stormy
nachsichtig	indulgent
kultivieren	cultivate
heimkommen	come home
nachlässig	careless
anziehend	attractive
überfluten	flood
Abstammung	ancestry
praktizieren	practice
aufgreifen	pick up
Korsett	corset
anfragen	Requests
verheilen	heal
vertagen	adjourn
Rindfleisch	beef
Staatssekretär	State Secretary
Tollwut	rabies
Erfrischung	refreshment
Apostel	apostle
spionieren	spy
verwirklichen	realize
montags	on Monday
freitags	friday
erwünscht	he wishes
handhaben	handle
Auflage	Edition
abladen	unload
Inspektion	inspection
gutaussehend	good looking
fünfmal	five times
überfordern	overwhelm
schleudern	fling
Vermieter	landlord
Verpflegung	Catering
exotisch	exotic
Vorkehrung	precaution
zweifelsohne	without a doubt
Rasiermesser	razor
aufschlagen	crack open
Geheimhaltung	confidentiality
Umkleideraum	Changing room
Reiseführer	travel Guide
vorlegen	submit
heizen	heat
eindrucksvoll	impressively
Raumschiff	Spaceship
verlässlich	reliable
Sekte	sect
ansteigen	increase
haargenau	exactly
authentisch	authentic
sommers	summer
gültig	valid
Einwanderungsbehörde	Immigration service
Knüppel	stick
runterholen	jerk off
Ernährung	nutrition
Haltestelle	bus stop
stramm	tight
Arbeiter	Workers
entschließen	decide
Delle	Dent
Kontaktlinse	Contact lens
Curry	curry
Abbruch	cancellation
Taiwan	Taiwan
intim	intimate
schmeichelhaft	flattering
Toilettenpapier	Toilet paper
Bezeichnung	description
erhaben	sublime
uralt	ancient
zerstreuen	disperse
Weihnachtsbaum	Christmas tree
Vorliebe	preference
Eroberung	conquest
Beratung	consultation
sparsam	economical
Faulpelz	Lazy
heimbringen	bring home
afrikanisch	African
Gurke	cucumber
Enthusiasmus	enthusiasm
unnatürlich	unnatural
Rivale	rival
prägen	shape
Steinbruch	Quarry
wegfliegen	fly away
legendär	legendary
erniedrigend	humiliating
Falschgeld	Counterfeit money
aufkreuzen	show up
beschwören	conjure up
nominieren	nominate
Knacker	Geezer
hundertmal	a hundred times
vorgeben	pretend
Kanne	Jug
lieblich	lovely
widerwärtig	disgusting
Pyramide	pyramid
aufschneiden	cut open
hundertprozentig	one hundred percent
knallhart	tough
höchstwahrscheinlich	most likely
bestenfalls	at best
Spielplatz	playground
Plakat	poster
drängeln	jostle
Angriff	attack
einweisen	instruct
unbezahlbar	priceless
zerren	tug
übersteigen	exceed
einlösen	redeem
Wucht	Stunner
Fluchtweg	escape route
Isolation	isolation
Toleranz	tolerance
inakzeptabel	unacceptable
Übersee	Overseas
Libanon	Lebanon
entladen	unload
Grundsatz	principle
unberührt	untouched
Wetterbericht	Weather report
verzeichnen	record
Haftstrafe	prison sentence
Aufschlag	surcharge
Protein	protein
Nordamerika	North America
Kraftwerk	power plant
vortragen	present
Splitter	Splinters
Schnüffler	snoop
Joghurt	yogurt
psychisch	mentally
nachladen	reload
nachvollziehen	comprehend
Moderator	Moderator
Tränengas	Tear gas
Stereoanlage	stereo system
motivieren	motivate
Comic	Comic
Kuwait	Kuwait
Adoption	adoption
Moos	moss
überlasten	overload
belagern	besiege
liebenswert	adorable
einreden	persuade
Säbel	saber
Chemiker	Chemist
uninteressant	uninteresting
überrascht	surprised
besaufen	get drunk
begeistern	inspire
überdrüssig	weary
Bestandteil	component
schläfrig	sleepy
optisch	optically
Fußabdruck	footprint
abführen	dissipate
absichern	to secure
rascheln	rustle
Pferderennen	horse race
wiederherstellen	restore
Zement	cement
schimpfen	rant
Gleichheit	equality
bedingen	condition
unehrlich	dishonest
Reservat	reserve
niederbrennen	burn down
stehend	standing
hervorrufen	cause
Anstellung	employment
Abteilungsleiter	Head of department
demokratisch	democratically
unverantwortlich	irresponsible
hinführen	lead there
Schub	thrust
schmieden	forge
hinschicken	send there
Unterbewusstsein	Subconscious
ungeheuerlich	monstrous
eignen	suitable
austragen	deliver
Verwandtschaft	relationship
zwangsläufig	inevitably
abhacken	chop off
trüben	tarnish
ablassen	drain
Fiktion	fiction
Kupplung	coupling
Eifer	zeal
Turnhalle	gym
Frequenz	frequency
siebzehn	seventeen
verwanzen	bug
Hasch	hash
Kapuze	Hood
Anwendung	application
Lungenkrebs	Lung cancer
grandios	terrific
Gelaber	Gelaber
absuchen	search
undenkbar	unthinkable
Teilnahme	participation
gliedern	structure
Goldmine	Gold mine
Geschlecht	gender
Gemetzel	slaughter
kugelsicher	bulletproof
Hausherr	Landlord
Jamaika	Jamaica
aufdrehen	turn up
oberhalb	above
Fläche	surface
wiedergeben	reproduce
weiterreden	keep talking
unbrauchbar	unusable
lebenslang	lifelong
rings	around
rücksichtsvoll	considerate
langen	long
Küken	chick
tags	day
belehren	teach
Statistik	statistics
fluten	flood
Buffet	Buffet
ängstigen	scared
verladen	loaded
Vorabend	eve
strahlend	radiant
spaßig	funny
überführen	convict
Enkelkind	Grandchild
durchlaufen	run through
komponieren	compose
abschleppen	tow away
Effizienz	Efficiency
schwedisch	Swedish
abschreiben	copy
verschollen	lost
parat	ready
frustrierend	frustrating
Beruhigung	Reassurance
Mietwagen	Rental car
Courage	courage
äußerlich	externally
Demokrat	democrat
Erforschung	exploration
Dichtung	poetry
problemlos	problemfree
Nahaufnahme	Close up
abspielen	play
totlachen	laugh to death
Milz	spleen
Sperrgebiet	Restricted area
unterstellen	assume
Wachposten	Sentry
verkabeln	wire up
zusammensetzen	put together
einigermaßen	to some extent
Sims	Sims
vertrauenswürdig	trustworthy
Urne	urn
verschwitzt	sweaty
Peilung	bearing
verwundbar	vulnerable
panisch	panicked
Teddybär	teddy bear
Sirup	syrup
Opium	opium
etliche	quite a few
Talisman	talisman
Investor	investor
radikal	radical
Seelenklempner	Shrinker
Vietnamese	Vietnamese
Anforderung	Requirement
sortieren	sort by
Pot	pot
Ablenkungsmanöver	Diversionary maneuvers
führend	leading
Lehrbuch	Textbook
unerfahren	inexperienced
Erstaunen	astonish
Lawine	avalanche
bunt	colorful
umfassen	include
vererben	to inherit
Buße	Buses
auspeitschen	whip
begnadigen	pardon
beehren	honor
Sketch	sketch
Unternehmer	Entrepreneur
ungestraft	with impunity
Türsteher	Bouncer
Ekstase	ecstasy
auskennen	know about
überschwemmen	flood
bügeln	iron
Zahnstocher	toothpick
schlüpfen	Hatch
Gefährte	fellow
Kreuzzug	crusade
Revanche	revenge
Vorrang	priority
bewilligen	approve
zulegen	gain
salutieren	salute
versohlen	wallop
festnageln	nail down
Rekord	record
kräftigen	strengthen
tarnen	camouflage
atemberaubend	breathtaking
Funke	spark
Mixer	mixer
anfordern	request
Waffenhändler	Arms dealer
Verweilen	linger
Flugticket	Plane ticket
walten	rule
Beurteilung	evaluation
überfüllen	overcrowding
Schriftsteller	writer
minderjährig	underage
funkeln	sparkle
startbereit	ready to go
vorherig	previous
Schultag	school day
zugunsten	in favor of
nunmehr	now
Gästeliste	guest list
gell	right
zugucken	watch
Vergnügungspark	theme park
durchdringen	penetrate
durchbohren	pierce
verdammen	condemn
hingeben	surrender
Refrain	refrain
Flammenwerfer	flamethrower
sündig	sinful
Windschutzscheibe	Windshield
allerletzter	very last
Mond	moon
feindselig	hostile
Christentum	Christianity
Schützengraben	Trenches
Fluggesellschaft	airline
Apotheker	pharmacist
entnehmen	remove
verbocken	mess up
Richter	Judge
Videokamera	Video camera
Most	Must
Fiasko	fiasco
verabreichen	administer
dämmern	dawn
schwungvoll	lively
verschulden	fault
Eroberer	conqueror
formulieren	formulate
knistern	crackle
wohlhabend	wealthy
Fußspur	Footprint
Patriotismus	patriotism
anprobieren	try on
Kranz	wreath
herbitten	ask
Einzug	Indent
Popo	Popo
Gewässer	Waters
herrichten	prepare
Vorsehung	providence
untröstlich	inconsolable
Volt	volt
auszahlen	pay off
Hinterausgang	Back exit
Suchtrupp	Search party
Unterfangen	Endeavor
demütig	humble
Juwelier	jeweler
Weber	Weber
unzertrennlich	inseparable
Portrait	portrait
schmerzlich	painful
Abzweigung	Junction
Überfluss	abundance
Blackout	blackout
hoffnungsvoll	hopeful
zugehen	approach
rechtlich	legally
Beben	Quake
Überlegung	consideration
Saat	seed
erfolglos	unsuccessful
Arsenal	arsenal
Showgeschäft	Show business
smart	smart
Versöhnung	reconciliation
hegen	cherish
binnen	within
Label	Label
auswärts	away
Einblick	insight
Kolben	piston
Bewachung	Guarding
unvorsichtig	careless
vertun	miss
schlaff	limp
Badeanzug	swimsuit
Mitmensch	Fellow man
schmal	narrow
Copyright	copyright
anzapfen	tap
Chrom	chrome
fegen	sweep
beständig	resistant
künftig	future
verzehren	consume
Müdigkeit	fatigue
Sternschnuppe	Shooting star
Durchsuchung	search
Sporthalle	Gym
erwählen	choose
Luxemburg	Luxembourg
Rat	advice
Regenzeit	Rainy season
Parole	parole
Witzfigur	Joke figure
abschicken	send
Autopilot	Autopilot
bewerten	evaluate
masturbieren	masturbate
Militärpolizei	military police
zuallererst	first of all
unterziehen	undergo
Hummel	bumblebee
Komplott	plot
impotent	impotent
hämisch	malicious
fixieren	fix
Krieger	warrior
Transfer	transfer
Sicherheitsvorkehrung	Security precaution
zurückverfolgen	trace back
violett	violet
Bosnien	Bosnia
Therapeut	therapist
Totenkopf	Skull
(he)rausfliegen	(he) fly out
abspringen	jump off
Gespött	mockery
behutsam	gently
Feindseligkeit	Hostility
Statthalter	Governor
Schraubenschlüssel	Wrench
nachwachsen	grow back
selbstsicher	self confident
Zeugenschutzprogramm	Witness protection program
bescheren	grant
Hausfriedensbruch	Trespassing
Bundesstaat	State
tolerieren	tolerate
Ermessen	discretion
verzweifeln	despair
anketten	chain
mühen	to struggle
weiterspielen	keep playing
Schlückchen	sip
Rettungsboot	Lifeboat
Bootshaus	Boathouse
mürrisch	grumpy
Schauspielerei	Acting
Requisit	prop
pausenlos	nonstop
Privatbesitz	Privately owned
distanzieren	distance
Formalität	formality
Voraussetzung	requirement
skrupellos	unscrupulous
Jockey	jockey
Gewissensbiss	Remorse
Arrangement	arrangement
diesbezüglich	in this regard
erlöschen	go out
schrubben	scrub
gesellschaftlich	socially
vorzeitig	prematurely
beabsichtigen	to intend
aushelfen	help out
erhoffen	hope
deportieren	deport
einwenden	object
strikt	strictly
Sonderangebot	special offer
dreitausend	three thousand
Erzählung	narrative
inspizieren	inspect
Eisberg	iceberg
einschätzen	assess
weinend	weeping
Schusslinie	Line of fire
Jubiläum	anniversary
erdulden	suffer
Sommerferien	summer holidays
Baseballschläger	Baseball bat
Patriot	patriot
Präsidium	Bureau
signieren	sign
allererster	very first
Magd	Maid
Vergaser	Carburetor
koordinieren	coordinate
Uhrwerk	clockwork
unerwünscht	undesirable
freisprechen	to acquit
Petroleum	petroleum
Bürde	burden
Abschiedsbrief	Farewell letter
Weckruf	Wake up call
Klapsmühle	Loony bin
Zitrone	lemon
(he)runterlassen	(he) let down
Gebäck	Pastries
zurückschlagen	strike back
durchsichtig	transparent
Fläschchen	Vials
beflecken	stain
Konvention	Convention
Schürze	apron
Nichtraucher	Nonsmoker
Mathematiker	mathematician
färben	to dye
Sieg	victory
konstant	constant
Zauberspruch	Magic spell
sarkastisch	sarcastic
Partikel	Particles
Vergessenheit	oblivion
Nobelpreis	Nobel Prize
Meineid	perjury
rundherum	all around
leitend	conductive
unfruchtbar	barren
Nahrungsmittel	food
Oberschenkel	Thigh
Kohlendioxid	Carbon dioxide
schrill	shrill
Ballast	ballast
Luftschleuse	Airlock
Abschuss	Launch
Erektion	erection
Milliardär	billionaire
reintun	Put in
abkaufen	buy off
auslegen	interpret
vermachen	bequeath
Lokomotive	locomotive
Raubtier	Predator
Sonnenbrand	sunburn
Krücke	crutch
verübeln	resent
allerhand	all sorts of things
zurückhaltend	reluctant
aufbleiben	stay up
unterkriegen	get down
Hering	herring
Redensart	Idiom
Attrappe	dummy
verlogen	lying
kitschig	cheesy
heimkehren	return home
Salzwasser	Salt water
achtern	aft
Ventilator	fan
Bewunderer	admirer
Spinat	spinach
Depot	depot
Operationssaal	operating room
anmaßend	presumptuous
übereinander	on top of each other
schnitzen	to carve
Blindgänger	Duds
Annäherung	Approximation
umstimmen	change your mind
Blech	sheet
Gespür	flair
amputieren	amputate
unwiderstehlich	irresistible
Aufpasser	Watchdog
Gestein	rock
Wunderkind	wonder child
sabotieren	sabotage
erzwingen	force
aussperren	lock out
windig	windy
Bürgerrecht	Civil rights
Schaufenster	Store window
revanchieren	retaliate
Wahlkampf	Election campaign
anbauen	plant
Denkweise	Way of thinking
Jacht	yacht
beanspruchen	claim
Dossier	dossier
fatal	fatal
Waffel	waffle
abwaschen	wash up
Sprengung	Demolition
glaubwürdig	believable
irrsinnig	insane
Dienstmarke	Badge
Gram	Grief
isolieren	isolate
Lied	song
zehnter	tenth
solang	so long
Intrige	intrigue
überlaufen	run over
Zuckerwatte	cotton candy
Sicherheitsmaßnahme	Security measure
Mitfahrgelegenheit	Carpooling
Hochhaus	skyscraper
Schutzschild	Protective shield
Stumpf	Stump
austrinken	drink up
verspannen	brace
Richtlinie	Directive
Telefonat	Phone call
Kleiderschrank	wardrobe
Antarktis	Antarctic
beliebig	any
abtrennen	split off
abservieren	dump
Deal	deal
kubanisch	Cuban
inhaftieren	imprison
verspotten	to mock
steppen	quilting
Brut	Brood
Perversion	perversion
Wiederbelebung	revival
hektisch	hectic
Alge	alga
Nigeria	Nigeria
Hygiene	hygiene
fauchen	hiss
problematisch	problematic
Kot	Feces
Gequatsche	Chatter
kreieren	create
käuflich	for sale
Biographie	biography
Videospiel	Video game
Webseite	website
paarmal	few times
asiatisch	Asian
überfällig	overdue
Exempel	example
entfallen	omitted
Medizinmann	Medicine man
voraussagen	predict
Tiefpunkt	Low point
neunter	ninth
freilich	of course
notfalls	if necessary
Verfolgungsjagd	chase
Straßenrand	Roadside
quetschen	to squeeze
rülpsen	burp
Set	set
schlafend	asleep
Orgel	organ
Ration	ration
landesweit	nationwide
verfaulen	rot
hocherfreut	delighted
Geldbörse	wallet
herausbekommen	get out
experimentieren	experiment
Unterredung	Conversation
würfeln	roll the dice
wegschaffen	carry away
Turnen	do gymnastics
Strauß	ostrich
tadellos	impeccable
Deserteur	deserter
hinausgehen	go out
umsetzen	implement
Menschenrecht	Human right
Trommelwirbel	Drum roll
mittwochs	Wednesdays
Fohlen	foal
ekelig	disgusting
seltsamerweise	oddly enough
zuweisen	to assign
Reptil	reptile
unwirklich	unreal
fließend	fluently
dauerhaft	permanent
Romantiker	Romantics
husch	hush
Faschismus	fascism
gleichermaßen	equally
wiedergutmachen	make amends
Foyer	foyer
begründen	justify
unwissend	ignorant
ausführlich	detailed
Schlafsack	Sleeping bag
anbeißen	bite
Schauer	shower
Spionage	espionage
Barriere	barrier
einchecken	check in
Reisebüro	Travel agency
rübergehen	go over
schrumpfen	shrink
unordentlich	messy
anstiften	instigate
anregend	stimulating
freundlicherweise	kindly
ausrufen	calling out
anspruchsvoll	demanding
Kapsel	capsule
tätowieren	tattoo
schwanken	vary
stampfen	stamp
pellen	peel
akzeptabel	acceptable
schwinden	dwindle
Blickfeld	Field of view
losziehen	go off
seitlich	laterally
olympisch	Olympic
röhren	to roar
abkratzen	scrape off
persisch	Persian
Einkauf	Purchasing
Gedärm	Intestines
juristisch	legal
spektakulär	spectacular
Schlagzeuger	drummer
leuchtend	bright
Kruste	crust
ausgeglichen	balanced
gigantisch	gigantic
nachsitzen	detention
verschmelzen	merge
Navigator	navigator
Tötung	killing
diesjährig	this year
Verzeichnis	directory
irrational	irrational
Nächstenliebe	Charity
Tschechoslowakei	Czechoslovakia
Goldstück	Gold piece
einerseits	on the one hand
Dirne	Whore
bergauf	uphill
Erbe	heritage
zermalmen	crush
Streber	nerd
Rockstar	Rock star
weiterführen	continue
Aussprache	pronunciation
Fanfare	fanfare
verbleiben	remain
Frustration	frustration
Boden	ground
ermüden	fatigue
zerfallen	disintegrate
Pforte	Gate
aufbrauchen	use up
sechsmal	six times
zwischendurch	occasionally
zusammentun	team up
wasserdicht	waterproof
undicht	leaky
verblassen	fading
grübeln	brooding
Meute	pack
Zeugenaussage	Testimony
Plunder	plunder
vorhersagen	predict
Begründung	Reason
Sonnenstrahl	Sunbeam
Planänderung	Change of plan
erringen	win
Streuner	Strays
preisgeben	reveal
Äffchen	little monkey
Menschenseele	Human soul
einfädeln	thread
donnerstags	Thursdays
Schnäppchen	bargain
dabeihaben	have along
Freiheitsstatue	statue of Liberty
verführerisch	seductive
vernarren	fond
realisieren	realize
hinsichtlich	regarding
Identifikation	ID
Lautstärke	volume
berüchtigt	notorious
Widmung	dedication
respektvoll	respectful
fasten	fast
Besteck	cutlery
Abneigung	antipathy
nachmachen	imitate
ausrotten	exterminate
Fotografie	photography
schwirren	buzz
Zufluchtsort	Haven
Macke	Quirk
Betäubungsmittel	Narcotics
lächelnd	smiling
Lava	lava
ehrenvoll	honorable
vormittags	morning
schummeln	cheat
Fechten	fencing
Vorzug	Preference
gewandt	agile
Pfütze	puddle
Bürste	brush
Paddel	paddle
Schwert	sword
einschenken	pour out
ereignen	happen
Slogan	slogan
phänomenal	phenomenal
weglassen	omitting
Stabilität	stability
bürsten	to brush
Lieblingsfarbe	favourite colour
selbständig	independent
Linse	lens
kombinieren	combine
Modus	mode
verlangsamen	slow it down
faxen	fax
Kollision	collision
Fahrzeug	vehicle
unscharf	blurred
Überwachungskamera	Security Camera
systematisch	systematically
sprayen	spray
mähen	mowing
dämpfen	dampen
Serbien	Serbia
Schuhgröße	Shoe size
ungehorsam	disobedience
Bit	bit
übereinstimmen	to match
Finderlohn	Finder's reward
leichtfertig	frivolously
Bitterkeit	bitterness
Minderheit	minority
Lokführer	Train driver
Pferd	horse
Leichenbeschauer	Coroner
gutgehen	go well
Huf	hoof
eifrig	eager
einstimmig	unanimously
Tapete	wallpaper
Telefonist	telephone operator
nachholen	catch up
abwehren	fend off
herumfahren	drive around
hereinspazieren	walk in
kurzsichtig	nearsighted
entstellen	disfigure
Strophe	verse
Herausgeber	editor
Steuermann	Helmsman
Kupfer	copper
versteigern	auction
Plutonium	plutonium
Socke	sock
anbelangen	concern
todsicher	dead certain
bändigen	tame
Eisschrank	Icebox
erstarren	freeze
zurückweisen	deny
Ernennung	appointment
wortwörtlich	literally
zieren	adorn
Pokal	Cup
drastisch	drastic
Tal	valley
Ausbeutung	exploitation
Slum	slum
verduften	evaporate
Gegenangriff	Counterattack
picken	peck
Riesending	Huge thing
heldenhaft	heroic
vorschreiben	prescribe
Konzentrationslager	concentration camp
agieren	act
Anführer	leader
Armbanduhr	Wrist watch
Henne	hen
Verfolger	Pursuer
Zusammentreffen	Meeting
schütten	pour
hochheben	lift up
blitzschnell	lightning fast
freimachen	clear
einstufen	classify
parallel	parallel
Kost	Food
hierzu	For this
zeitig	in time
überbrücken	bridge
Ehrenmedaille	Medal of Honor
eskortieren	escort
Pose	pose
Hosentasche	pocket
Karat	carat
Rudel	pack
mäßig	moderate
beschneiden	trimming
Schwertkampf	Sword fighting
Stickstoff	nitrogen
dienstags	Tuesdays
Schema	Scheme
verschlechtern	worsen
Einsicht	Insight
Koje	bunk
Geschoss	bullet
Bubi	Boy
einlochen	pound
woandershin	elsewhere
Mappe	Folder
kanadisch	Canadian
Schlüpfer	panties
Motte	moth
unartig	naughty
Amnestie	amnesty
Muslim	Muslim
lässig	casual
verhängen	impose
Zusammensetzung	composition
umschreiben	rewrite
Ziffer	Digit
(he)rausschneiden	(he) cut out
Abschlussfeier	Graduation ceremony
beleuchten	illuminate
wirtschaftlich	economically
schwängern	get pregnant
interpretieren	interpret
Justizminister	Justice Minister
Faser	fiber
Pate	Godfather
sonnig	sunny
Phase	phase
Lateinamerika	Latin America
Festplatte	hard disk
ausschwärmen	swarm out
Petition	petition
Konfrontation	confrontation
Hardware	hardware
Spurensicherung	Forensics
human	humane
hochnehmen	pick up
währen	to last
bevorstehend	forthcoming
Innenminister	Minister of the Interior
abbeißen	bite off
Bettchen	Crib
Kluft	gap
anpacken	tackle
generell	As a general rule
morgiger	tomorrow
Bildhauer	sculptor
eintausend	one thousand
Erhöhung	increase
Verbandszeug	Bandages
trostlos	bleak
Hinterteil	Rump
klirren	clink
brenzlig	dicey
Navigation	navigation
Orakel	oracle
hissen	hoist
festsitzen	get stuck
Verwechslung	confusion
taktvoll	tactful
wirr	confused
kleinlich	petty
unbeschreiblich	indescribable
empört	outraged
inspirierend	inspiring
Hehler	Fence
demütigend	humiliating
entzwei	in two
Tagung	meeting
Kleinkind	small child
verzögern	delay
Maschinerie	machinery
erblicken	catch sight of
Appell	appeal
Kittchen	Putty
anflehen	implore
unklug	unwise
besiegeln	seal
Lakai	Lackey
folgendermaßen	as follows
durchlassen	let through
bekleiden	clothe
Vorsichtsmaßnahme	Precaution
Verhängnis	Doom
Gaul	Horse
freisetzen	release
konservativ	conservative
hinterhältig	sneaky
Roulette	roulette
tatenlos	inactive
hierüber	about this
(he)rausbekommen	(he) get out
Eiszeit	Ice age
frisieren	comb
Arterie	artery
urkomisch	hilarious
Trumpf	Trump card
erkranken	get sick
Fluglinie	Airline
begrenzen	limit
permanent	permanent
assistieren	assist
Horoskop	horoscope
Gebiss	denture
Bewusstsein	awareness
verrichten	perform
Rasierer	Razor
furchterregend	terrifying
Zusammenfassung	Summary
abräumen	clear away
sogleich	immediately
Partisan	partisan
Schwadron	squadron
unterlassen	fail
Wendepunkt	Turning point
Dialog	dialog
quieken	squeak
applaudieren	applaud
Pilz	mushroom
Gladiator	gladiator
genesen	recovered
widerrufen	withdraw
Weihnachtszeit	Christmas time
Transvestit	transvestite
Lagune	lagoon
verwischen	blur
Zepter	scepter
Kunststück	sleight of hand
vertieft	deepened
ratlos	at a loss
Geburtstagsparty	Birthday party
Arznei	Medicament
anbinden	tie up
üblicherweise	usually
Transaktion	transaction
Rehabilitation	rehabilitation
Kettenreaktion	Chain reaction
Sozialhilfe	social care
rätselhaft	enigmatic
Vorsatz	Intent
übertreten	trespass
ungerade	odd
Sicherheitsleute	Security guards
schiefgehen	go wrong
weiterlaufen	keep walking
Jahrbuch	Yearbook
Codename	Code name
lokalisieren	locate
Astronomie	astronomy
Tang	Tang
Tentakel	tentacle
schmücken	decorate
Jalousie	louvre
labern	babble
ausrücken	move out
Besinnung	reflection
verscheuchen	scare away
Knechtschaft	bondage
Zahlmeister	Paymaster
Verdammnis	damnation
Straßenbahn	tram
austeilen	hand out
jeher	always
Überraschungsparty	surprise party
hierauf	on this
Seemann	sailor
Kenner	Connoisseur
ausbilden	form
Probeaufnahme	Test recording
anderweitig	elsewhere
Diplomat	diplomat
trödeln	dawdle
einbuchten	log in
halbtot	half dead
Patenonkel	Godfather
Lähmung	paralysis
eingestehen	admit
auftragen	Instruct
herunterkommen	come down
kerngesund	perfectly healthy
Wildschwein	wild boar
verspeisen	eat
anbeten	worship
Herzversagen	Heart failure
gottlos	godless
versteinern	petrify
Glühwürmchen	Firefly
verweisen	refer
entlarven	expose
Kauderwelsch	gibberish
gemach	chamber
Aroma	Aroma
bereinigen	clean up
Guatemala	Guatemala
Segelboot	Sailboat
Verleihung	Award
Wollust	Lust
streuen	sprinkle
verstauchen	sprain
Auslaufen	leak
tratschen	gossip
Parkett	parquet
Weihwasser	holy water
Verdeck	Convertible top
Kinderheim	Children's home
entfachen	kindle
delikat	delicate
importieren	import
barsch	perch
Akkordeon	accordion
Zusammensein	Be together
veralten	obsolescence
soundso	so and so
ausreißen	run away
Töchterchen	Daughter
Skifahren	To ski
Verdauung	digestion
weggeben	to give away
fünfhundert	fivehundred
zuweilen	at times
Kokosnuss	coconut
Anleihe	bond
Ultimatum	ultimatum
Bistro	bistro
populär	popular
verfangen	caught
Besuchszeit	Visiting time
unbegreiflich	incomprehensible
entbinden	give birth
Stäbchen	rod
Überfall	Raid
Misserfolg	failure
prachtvoll	splendid
sitzend	sitting
kraftvoll	powerful
zumal	especially
Steinzeit	Stone age
ordinär	vulgar
vorstellbar	imaginable
Schwalbe	swallow
erträumen	dream
fortan	henceforth
belanglos	irrelevant
durchschlagen	punch through
Segler	Sailors
zurückgewinnen	win back
Rollbahn	Runway
Kulisse	Backdrop
zusammenpassen	match
Karpfen	carp
entsorgen	to dispose
Nordkorea	North Korea
Krümel	Crumbs
losmachen	unleash
lagern	to store
abschütteln	shake off
Werbespot	commercial
Atomkrieg	Nuclear war
zerschneiden	cut
stricken	knit
Geruch	odor
knusprig	crispy
Überweisung	Transfer
Krankenversicherung	Health insurance
Kleber	Glue
adlig	noble
Spezialgebiet	Specialty
dehnen	stretch
disqualifizieren	disqualify
Ausgangspunkt	starting point
Brustkorb	Rib cage
spekulieren	speculate
Bagger	Excavator
Indio	Indio
mechanisch	mechanically
explosiv	explosive
Gleichung	equation
bekümmern	grieve
Globus	globe
Meteorit	meteorite
Puck	puck
Heiligkeit	holiness
lateinisch	Latin
Zyklop	Cyclops
Meeting	meeting
Weltbank	World bank
Untergeschoss	Basement
schädlich	harmful
verletzlich	vulnerable
Schwellung	swelling
Delirium	delirium
willig	willing
verkriechen	crawl away
Verleumdung	Defamation
barmherzig	merciful
prophezeien	prophesy
Hohn	Scorn
brünett	brunette
dableiben	stay there
exekutieren	to execute
Nordwest	northwest
scharfsinnig	astute
Bandenkrieg	Gang war
konkurrieren	compete
reinschauen	take a look
zusammenbringen	bring together
Baumstamm	Tree trunk
mitsamt	including
Sondereinheit	Special unit
niederlassen	settle down
Schallplatte	vinyl record
gewährleisten	guarantee
Ablösung	Detachment
melken	milking
Pelzmantel	Fur coat
Melancholie	melancholy
wüten	rage
Klaps	pat
verspüren	feel
vorsätzlich	deliberately
Börsenmakler	Stock broker
enthaupten	behead
geistreich	witty
verschlossen	locked
eigensinnig	stubborn
Brautkleid	wedding dress
Masern	measles
geleiten	guide
einrosten	rust
Heuschrecke	grasshopper
Indiz	indication
postieren	post
Funker	Radio operator
Rummel	Hype
ködern	bait
verwalten	manage
Giraffe	giraffe
kandidieren	to run
vielerlei	many
Triade	Triad
einteilen	organize
Likör	liqueur
Scheckbuch	Checkbook
bürgerlich	civil
Bundesgericht	Federal court
Bürokratie	bureaucracy
unbequem	uncomfortable
hilfsbereit	helpful
(he)rausfahren	(drive out
Wimper	eyelash
digital	digital
rekrutieren	recruit
Deckname	Alias
herausstellen	turn out
Interpretation	interpretation
dickköpfig	stubborn
Erpresser	blackmailer
Morgenmantel	Dressing gown
Engländer	English people
gesprächig	talkative
schöpfen	scoop
Etikette	etiquette
nachlassen	ease up
Lack	paint
Schar	Crowd
entziffern	decipher
unvorbereitet	unprepared
Lockvogel	decoy
wegpusten	blow away
Badehose	swimming trunks
lebenswert	livable
quaken	croak
adressieren	address
Eiswasser	Ice water
Beinbruch	Broken leg
Umwandlung	conversion
Verpackung	packaging
Zeppelin	Zeppelin
Rittmeister	Rittmeister
entbehrlich	dispensable
zunehmend	increasingly
Todestag	Date of death
entschädigen	compensate
Werfer	Thrower
nähren	nourish
Eiswürfel	Ice cubes
Schachzug	move
Müsli	cereal
Drecksloch	Bastard
wahllos	indiscriminately
zickig	bitchy
unheilvoll	ominous
Variante	variant
stapeln	stack
Transplantation	transplantation
Generalstaatsanwalt	Attorney General
Vorkommnis	Incident
katastrophal	catastrophic
Meisterstück	masterpiece
salzig	salty
Diagramm	diagram
wöchentlich	weekly
verschlimmern	aggravate
Detonation	Detonation
demolieren	demolish
Fahrwerk	landing gear
Verbreitung	distribution
Konferenzraum	Conference room
Nullpunkt	Zero point
Macker	Bugger
rassistisch	racist
anschaffen	acquire
kommerziell	commercially
Guru	guru
organisch	organic
Gemeindezentrum	Community center
ausräumen	clear out
versessen	obsessed
Beisein	To be present
wirksam	effective
Einhalt	Halt
schänden	disgrace
knabbern	nibble
Heiligtum	sanctuary
Brosche	brooch
Wettrennen	Race
Überzahl	Outnumbered
Flop	Flop
Lebzeit	Lifetime
glühen	glow
unverheiratet	unmarried
Grab	dig
Zusammenstoß	collision
aufgeregt	excited
ausarbeiten	working out
Storch	stork
berechtigt	entitled
horten	hoard
Bankraub	Bank robbery
Korrespondenz	Correspondence
abdecken	cover
Intensität	intensity
Spritzer	Splash
Ruhestörung	Disturbance of the peace
Kap	cape
hellwach	awake
zappeln	fidget
Leichtigkeit	ease
verpfuschen	botch up
umfassend	full
senkrecht	perpendicular
abbauen	dismantle
unbewusst	unconsciously
durchkämmen	comb through
viertens	fourth
geistlich	spiritually
überkommen	come over
kribbeln	tingle
beschämend	shameful
überholen	overtake
Bombardierung	bombing
Füllung	filling
Abschiedskuss	Kiss goodbye
Einlage	inlay
metallisch	metallic
Pfahl	Stake
köpfen	heads
gutmütig	goodnatured
vernaschen	nibble
Postfach	Post office box
indiskret	indiscreet
Frack	Frack
Prohibition	prohibition
zweitausend	two thousand
Nationalität	nationality
unbegrenzt	unlimited
Monopol	monopoly
unergründlich	unfathomable
konfiszieren	confiscate
durchschnittlich	average
ausbringen	put out
ziellos	aimless
zeitweise	temporarily
Ebbe	ebb
Akkord	chord
Anlass	occasion
Halfter	holster
Immunität	immunity
Zielobjekt	Target object
verschmieren	smear
Weihrauch	incense
allerlei	all kinds
verkommen	go down
siegreich	victorious
Abendmahl	Supper
Signatur	signature
vorbeifahren	go by
(he)rumfahren	(Hey)
kulturell	cultural
Renaissance	Renaissance
einäugig	one-eyed
mitunter	sometimes
Gondel	gondola
Rasur	shave
säen	sow
energisch	energetic
übernatürlich	supernatural
Oberbefehlshaber	Commander
wahrhaben	perceive
Veröffentlichung	publication
abfallen	drop
willkürlich	arbitrarily
Rennfahrer	Racer
Plattenspieler	Turntable
symbolisieren	symbolize
zerkratzen	scratch
Generalsekretär	Secretary-General
Betäubung	Stunning
flexibel	flexible
ersuchen	request
Türke	Turk
Intimität	intimacy
Spielraum	Scope
Verstopfung	constipation
Rowdy	rowdy
zirka	about
(he)rausreißen	(Hey) tear
Altenheim	Old people's home
Startbahn	Runway
nichtig	void
bewölkt	cloudy
einschränken	restrict
Bestseller	bestseller
ignorant	ignorant
Platzpatrone	Flat cartridge
Forum	Forum
Hommage	Homage
Versuchskaninchen	Guinea pigs
unheilbar	incurable
hergerissen	torn
zivil	civil
Aufbruch	Departure
Broschüre	brochure
geschmeidig	smooth
unterbinden	stop
abtreiben	abort
Zehntel	tenth
Gefechtsstand	Battlestand
allerwichtigste	most important
Zusatz	additive
Spule	Kitchen sink
grundgütig	basic
versüßen	sweeten
Portal	portal
Gästehaus	Guest house
gedeihen	thrive
Wiedereintritt	Re-entry
aufholen	catch up
stressig	stressful
austreten	leaving
Verwarnung	warning
Proton	proton
Billion	trillion
Programmierer	programmer
Parkhaus	Parking garage
Impfstoff	vaccine
Immunsystem	immune system
spazierengehen	to go for a walk
einhundert	one hundred
qualvoll	trivorous
wissend	knowing
auffrischen	refresh
Gründung	founding
Verurteilter	Convicted
Einwohner	Inhabitant
entgegennehmen	accept
Eingangshalle	Entrance hall
derzeitig	current
seriös	serious
Vorrichtung	contraption
festfahren	set
zutragen	to wear
überwältigen	overwhelm
voreingenommen	biased
Hauptdarsteller	main actor
grenzenlos	boundless
schwenken	swing
auffüllen	fill up
unauffindbar	unfavorable
betören	buffing
erzürnen	tower
Röntgenbild	X-ray image
Gedächtnisverlust	Memory loss
Schnellzug	Quick train
Beunruhigung	Disturbance
Betrug	Scam
belauschen	enhance
Abendkleid	Evening dress
ungeschützt	unprotected
instinktiv	instinctively
zirpen	chirping
konföderiert	confederate
schwachsinnig	non-mindful
Memoiren	memoirs
weitersuchen	search for
verstimmen	misguide
erklingen	sound
Redner	Speaker
Geschwafel	Cruise
Kanarienvogel	canary
staubig	dusty
widerlegen	refute
alarmieren	alert
entrinnen	escape
Besitzurkunde	Property certificate
einsammeln	collect
Argentinier	Argentine
Haut	skin
Abschiedsgeschenk	Farewell gift
erschweren	make more difficult
Bergwerk	Mine
abwimmeln	get away
Gefangennahme	Capture
bücken	bend
Ruhestätte	Resting place
Konkurs	bankruptcy
Tanz	dance
niederträchtig	dull
Seemeile	nautical mile
Spazierfahrt	Walking trip
aufsagen	see on
Tänzchen	Dance
Kolonne	column
abwenden	turn away
Lerche	lark
abrechnen	settle up
abblasen	blow off
Etikett	label
dirigieren	conduct
krümmen	bend
besagt	stated
nächtlich	nocturnal
Symphonie	symphony
spaßen	shot
Dunst	haze
einwilligen	consent
Staatspolizei	Police police
nachtragend	sampling
Mütterchen	Munts
Apartment	Apartment
Sense	Scowl
wegblasen	blow away
ableben	discharge
Hundegebell	barking
Pulsader	Powder
mithelfen	help along
abmurksen	lose weight
aufrechterhalten	maintain
Delegation	delegation
Rüssel	Trunk
magnetisch	magnetic
Lektüre	reading
umwandeln	convert
weiterentwickeln	develop
Zweikampf	Battle
Attest	Medical certificate
Vorhut	vanguard
Gegengift	Counterpart
Master	master
Bettwäsche	Bedding
entfalten	unfold
Hemisphäre	hemisphere
ungewiss	uncertain
aufschließen	open up
gegenüberstehen	face
überheblich	murderly
Waffenruhe	Ceasefire
Vorgeschichte	prehistory
simulieren	simulate
mental	mental
massenhaft	massive
klebrig	sticky
erotisch	erotic
Striptease	striptease
Abstecher	Detour
Prognose	forecast
Kunstwerk	Artwork
wegmachen	go away
Schulabschluss	Graduation
Gegenüberstellung	Juxtaposition
verwehren	deny
anfällig	susceptible
einschleusen	smear
Auffahrt	Driveway
präsent	present
Blümchen	Floral
rhythmisch	rhythmical
Geburtstagskind	Birthday boy
Sicherheitsgurt	Safety belt
Bürokrat	bureaucrat
datieren	date
Schwachstelle	weak spot
Seriennummer	serial number
Brunch	brunch
Asphalt	asphalt
Masturbation	masturbation
saftig	juicy
Frust	frustration
Moslem	Muslim
andocken	docking
Rentner	pensioner
Bewerbungsgespräch	Job Interview
Seher	Seer
Pferdeschwanz	Ponytail
Tastatur	keyboard
Wellenlänge	wavelength
funktionsfähig	functioning
attackieren	attack
formell	formally
bloßstellen	expose
sorglos	carefree
Verführung	seduction
heimsuchen	haunt
unrein	unclean
entwaffnen	disarm
Hymne	anthem
Trubel	Bustle
kompromittieren	compromise
Anschrift	address
Gemeinheit	Meanness
gestreift	striped
viereinhalb	four and a half
kostspielig	expensive
Nebenzimmer	Adjoining room
Geber	giver
taktlos	tactless
Drehbuch	script
jeweilig	respective
Tonfall	Inflection
Bettlaken	Bedsheet
schädigen	damage
dasitzen	sitting
Betonung	Emphasis
huckepack	piggyback
Pflaume	plum
zuvorkommend	courteous
verschlüsseln	encrypt
galant	gallant
verwundert	surprised
vermerken	note
gefügig	confidently
Einfachheit	simplicity
Revolte	revolt
einweihen	inaugurate
Fell	fur
wogegen	whereas
festbinden	tie
desinfizieren	disinfect
zurückdrehen	turn back
inkognito	incognito
Speer	spear
verwehen	let
Brauch	Custom
kinderleicht	dead easy
Wiederwahl	Re-election
Pfosten	post
Lilie	lily
Robe	robe
Hochachtung	Respect
lockern	loosen
verlernen	unlearn
Ärgernis	Annoyance
matsch	mud
anbrennen	burn
ungemütlich	uncomfortable
verwetten	staple
huldigen	pay homage
weismachen	know
Aufmachung	Presentation
Vorstadt	Suburb
Einsturz	collapse
glitzern	glitter
Anhaltspunkt	reference point
stickig	stuffy
Zutrauen	confidence
Ankläger	Prosecutor
zähmen	tame
herfahren	drive up
Geschwader	squadron
Pflichtverteidiger	Duty defender
angehören	believe
Nervenkitzel	Thrill
jähzornig	irascible
Spargel	asparagus
Doktortitel	Doctorate
totschlagen	kill
beliebt	popular
Feindschaft	enmity
hintun	put
schwerhörig	hard of hearing
einäschern	uncheck
Sperrstunde	Curfew
Anschreiben	Write to
Zaster	Zaster
Schlachthaus	Slaughterhouse
Wortwahl	Choice of words
Einleitung	introduction
Niemandsland	no mans land
Irrenanstalt	Asylum
Filmgeschäft	Film shop
Comeback	comeback
Prozession	procession
Erdatmosphäre	Earth's atmosphere
unterbreiten	submit
weiterleiten	hand off
Aufforderung	request
austrocknen	dry out
(he)runterfallen	(falling off
Flirt	flirt
einflussreich	influential
Weihnachtsfest	Christmas
vibrieren	vibrate
Wohlfahrt	Welfare
verbiegen	bend
Überläufer	Trafficker
Vernehmung	Interrogation
Wartezimmer	Waiting room
zurücklegen	return
Scheideweg	crossroads
Heer	army
aufgeschlossen	open minded
nuklear	nuclear
Fragebogen	questionnaire
neunzehn	nineteen
dänisch	Danish
herankommen	get approached
verdursten	spend
Ferienlager	Vacation camp
Funkgerät	Radio
Abschlag	Tee
Privatnummer	Private number
Müllhalde	Dump
Schabe	Cockroach
Absprung	Jump
abbringen	dissuade
Zähler	counter
koreanisch	Korean
Reisepass	passport
hypothetisch	hypothetical
schleunig	throw
Sprechanlage	Intercom
betreuen	look after
untergeben	subordinate
Bankdirektor	Bank director
Wachdienst	Guard
degradieren	degrade
Gerinnsel	clot
skeptisch	skeptical
Rundgang	tour
Anbeginn	Start
reinhauen	pure
Gehirntumor	Brain tumor
Spülung	Flush
Waschbär	racoon
schwermütig	melancholy
Primat	primate
Motelzimmer	Motel room
irakisch	Iraqi
inbegriffen	included
unlogisch	illogical
versklaven	enslave
gedulden	tolerate
blinzeln	blink
Untier	monster
schweigsam	silent
grell	glaring
einbuchen	book
Osten	east
bedingungslos	unconditionally
Provokation	provocation
wimmeln	teemen
Obrigkeit	Authority
auflesen	stop
Besserungsanstalt	Improvement
Leichenwagen	Corner
gähnen	yawning
nachhelfen	help
rar	rar
horchen	listen
Pflug	plow
Monolog	monologue
ungewohnt	unfamiliar
Ruß	soot
knüpfen	make
einstürzen	collapse
Nachlass	estate
Pastete	Pate
schmusen	cuddle
Saustall	Sausetal
bürgen	guarantee
Gespann	Trailer
gackern	cackle
enttäuschend	disappointing
tonnenweise	barrel
bewegend	moving
erklimmen	climb
Duett	duet
einfallsreich	ingenious
flink	flink
unentschlossen	undecided
Liebchen	sweetheart
Tageszeit	Daytime
Hustensaft	Cough Syrup
auferlegen	impose
Absprache	Arrangement
aufblasen	inflation
Überlegenheit	superiority
Optimist	Optimist
statuieren	statulate
Wassermelone	Watermelon
Fotoapparat	Camera
Schottland	Scotland
Regent	regent
Klugheit	wisdom
Volk	people
Reinfall	Pure case
Monument	monument
Familienmitglied	family member
Hyäne	hyena
entlasten	relieve
abbezahlen	deposit
erheblich	significant
Klavierspieler	Pianist
Ausguck	Spooky
Kreuzworträtsel	Crossword
Clique	clique
Nichtsein	Not be
gekühlt	chilled
Pförtner	usher
barbarisch	barbaric
Rasierklinge	razor blade
erdrosseln	strangle
(he)runterbringen	(Hey)
herbestellen	regroup
verstellen	adjust
Schusswunde	Weighing wound
Fänger	Catcher
Sender	Channel
Bediensteter	Operator
Fallschirmjäger	Paratrooper
melodramatisch	melodramatic
aufgeschmissen	stuck
Konkurrent	competitor
geschwind	fold
beweglich	movable
Fingerspitze	Fingertip
Dampfer	Steam boat
Falltür	Drop-door
umsteigen	change
volltanken	fullrink
umtauschen	exchange
Kegel	cone
verrechnen	settle
Zielort	Destination
Komplexität	complexity
Leib	body
Diebesgut	Thief
zurückblicken	look back
pochen	throb
hochklettern	climbing up
Bettdecke	Duvet
Sommerhaus	Summer house
verwählen	reflect
aufgabeln	put up
orientalisch	Oriental
etabliert	established
Nagellack	nail polish
Konstellation	constellation
Aufgebot	Bid
visuell	visually
vorhersehbar	predictable
erbeuten	cauterize
Seelenheil	Soul
voraussehen	foresee
Quiz	quiz
paradox	paradox
Taverne	tavern
Eingangstür	entrance
Auktionator	auctioneer
prominent	prominent
vereint	united
Verordnung	regulation
rational	rational
Gewehrfeuer	Rifle
Eingabe	input
Zeitreise	Time travel
Bügel	hanger
Kopfverletzung	Head injury
dreihundert	three hundred
erwägen	consider
symbolisch	symbolic
Autoradio	Car radio
Körperbau	anatomy
Sterling	sterling
Kassierer	cashier
Törtchen	Tart
erliegen	succumb
Transmitter	Transmitter
obszön	obscene
Gewächshaus	Glasshouse
kraus	kraus
durchleben	experience
Friseuse	Frise
beziehungsweise	or
Rassismus	racism
vergleichbar	comparable
Aktivierung	activation
Elektron	electron
Vandalismus	vandalism
Umweltverschmutzung	environmental pollution
Herpes	Herpes
Kettensäge	chainsaw
Massenmörder	Mass murderer
Gebärmutter	uterus
Schnauze	snout
Sternbild	Constellation
vertikal	vertical
Marketing	marketing
aushandeln	negotiate
speicheln	salivate
überrennen	overrun
absorbieren	absorb
Filzlaus	Felt
Stirnband	Headband
Herzfrequenz	Heart rate
Joch	yoke
Diktator	dictator
fürwahr	tribute
besinnen	remember
Geselle	Journeyman
Gasthof	Inn
Bilanz	Balance
Berichterstattung	reporting
Flohmarkt	flea market
sechzig	sixty
Brandstifter	Arsonist
Sauerkraut	sauerkraut
ausladen	unload
unvollständig	incomplete
Schießeisen	Shooting iron
Register	register
achtzig	eighty
Wesen	Creature
Alleinsein	To be alone
Stube	Stube
duzen	duke
Nervosität	nervousness
sportlich	athletic
vorübergehen	pass
unhörbar	inaudible
Genialität	Geniality
erstbeste	first
flennen	flace
prinzipiell	in principle
befriedigend	satisfying
Unkosten	expenses
Hängematte	hammock
Kapitän	captain
austreiben	expel
Hochzeitskleid	Wedding dress
Rennpferd	Racehorse
Reservoir	reservoir
heimtückisch	insidious
unaufhörlich	incessant
betätigen	actuate
Handfläche	Palm
zuziehen	move
Schwingung	vibration
ehrbar	honorable
Konföderation	confederacy
vorfinden	find
Typhus	typhus
Torso	torso
kommandieren	command
rütteln	shake
abschaffen	abolish
abstatten	pay off
Vormarsch	March
erhitzen	heat
zurückkaufen	buy back
tropisch	tropical
Untertreibung	understatement
zudecken	cover up
bereitstehen	stand up
beleben	revive
Anspielung	innuendo
schimmeln	shimmish
lynchen	lynch
erstrecken	extend
Benutzung	use
Theater	theatre
Flussufer	River bank
auswirken	impact
verschanzen	hide
Stadtzentrum	City center
Sonderpreis	Special Price
kurieren	cure
Erhaltung	conservation
wälzen	roll up
Deckmantel	Coat
Trio	trio
Fehlgeburt	Miscarriage
basteln	handcraft
Telepathie	telepathy
Anmeldung	Registration
Prise	prize
Schalldämpfer	silencer
Revolverheld	Revolver
verstricken	entangle
abgelegen	remote
Analytiker	analyst
zapfen	tap
zuwenden	go to
Türschwelle	Barrier
Obsession	obsession
erwärmen	heat
unausstehlich	inept
Pünktlichkeit	punctuality
umkreisen	circle
gewünscht	wished
Terminkalender	Schedule
hinknien	hike
erstgeboren	firstborn
Lorbeer	laurel
verkehrt	wrong
steuerfrei	tax-free
vollstrecken	enforce
Trompeter	trumpeter
abwechselnd	alternately
ungemein	uncomfortable
doppeln	doubles
einwickeln	wrap
Zwangsjacke	Forced jacket
neutralisieren	neutralize
Telefongesellschaft	Telephone company
Honduras	Honduras
Hühnerstall	chicken coop
Trikot	shirt
volljährig	year-round
atomar	atomic
beherrscht	controlled
vorlaut	preliminary
ausspucken	spit
Säugetier	mammal
Merkur	Mercury
Kreuzigung	crucifixion
formieren	form
Polizeistation	Police station
Hufschmied	Hoarding
Weihnachtsfeier	Christmas party
zweierlei	two
Bohne	Bean
schändlich	shameful
Abschnitt	section
Keim	Germ
rundum	all around
gewissenhaft	conscientious
muh	moo
weben	weave
Kiosk	kiosk
radioaktiv	radioactive
Wohlgefallen	False
rumkriegen	go around
Tortur	torture
konkret	concrete
begutachten	inspect
unfehlbar	infallible
weglegen	put away
vorhersehen	forecast
erörtern	discuss
haften	be liable
Maat	Mat
Überbleibsel	Remnant
durchtrennen	ride through
Nervenklinik	Nerve clinic
Schmerz	pain
Nudelsuppe	noodle soup
Gewölbe	Vault
Absperrung	Barrier
terrorisieren	terrorize
würdevoll	graceful
Klotz	Log
ungeschoren	uncouth
vermessen	measure
Referat	presentation
Däne	Dane
Rentier	reindeer
Ursprung	origin
röcheln	rattle
unangemessen	unreasonable
Modul	module
Rolltreppe	Escalator
alsbald	soon
saukalt	sauce
Mobiltelefon	Mobile phone
ranfahren	ran
bekifft	stoned
diagnostizieren	diagnose
Strandhaus	Beach house
Podium	Podium
Herzattacke	Heart attack
überwiegend	mostly
Messung	Measurement
Geldmenge	Money
Krempel	Cremp
mystisch	mystical
zuwider	revival
selbstbewusst	confident
abstoßen	repel
zimperlich	squeamish
verbitten	prohibited
Hilfsmittel	Tool
missfallen	displeasure
schwärmen	swarm
Nordseite	North side
Allee	avenue
Verbannung	exile
vorzeigen	show
Gouvernante	governess
hochnäsig	upswing
Wildkatze	Wildcat
Erdnuss	peanut
Polizeischutz	Police protection
mithören	listen
weiterkämpfen	continue fighting
anmutig	graceful
zusammenführen	merge
glitschig	slippery
heimzahlen	pay back
Glückseligkeit	bliss
Makel	Blemish
(he)rausgeben	(Hey)
Aufmunterung	encouragement
zertreten	crush
Drüse	gland
andrehen	touch
geistesgestört	mentally
Stachel	Sting
Guthaben	Credit
Quacksalber	Quack
einschläfern	push
Mut	courage
herumführen	lead around
vereidigen	swear out
losschicken	send off
Kanonenkugel	Cannonball
Sombrero	sombrero
verkürzen	shorten
Brennstoff	fuel
Bauchweh	a stomach ache
verächtlich	contemptuously
Fokus	focus
beiwohnen	attend
Strudel	swirl
bekehren	convert
Kapazität	capacity
Filz	felt
Festmahl	feast
desertieren	desert
umkippen	tilt
glühend	glowing
anlassen	start
Passierschein	pass
befehligen	command
Ballade	ballad
unterstehen	undergo
Versicherungspolice	Insurance policy
ungehobelt	uncouth
abrasieren	abrasive
bisweilen	sometimes
verpatzen	chat
Hungersnot	famine
Metier	metier
Trauerfeier	Funeral
blinken	flash
Fastenzeit	Fasting time
bestreben	strive
gesellig	sociable
Aushilfe	Assistance
wirkungsvoll	effective
Adressbuch	directory
erkaufen	buy
zerbrochen	broken
verschmutzen	pollute
ungebildet	uneducated
vortanzen	dance
prüde	prudish
annähen	sew on
derweil	Meanwhile
vereinfachen	simplify
erbarmungslos	merciless
abschieben	enlove
kühlen	cool
mitarbeiten	cooperate
rutschig	slippery
schweigend	silent
Kriegsschiff	Warship
splitternackt	naked
Zurückhaltung	Restraint
Betrachtung	Consideration
durchsehen	look through
pudern	powder
Obstgarten	Orchard
fettig	greasy
stilvoll	stylish
stranden	stretch
drosseln	throttle
gottverlassen	god
tugendhaft	virtuous
Hinblick	Liability
Nachteil	disadvantage
Kimono	kimono
Boutique	boutique
Lotus	lotus
großmütig	magnanimous
Renner	Racer
verunsichert	unsettled
entflammen	flare up
vollstopfen	stuff
kuscheln	cuddling
verdrücken	crush
vereinzelt	occasional
Ringrichter	Frier
verunglücken	tinker
Kripo	Cripple
Ausdehnung	expansion
Schramme	Scrape
Betreuung	care, support
Ordner	folder
Straßensperre	Roadblock
verdauen	digest
übersäen	tab
Ignoranz	ignorance
wegschmeißen	throw it away
Verwundung	Wound
Elektroschock	Electric shock
entgegenkommen	meet
Selbstmordversuch	Suicide
Sammelpunkt	Collecting point
Cholesterin	cholesterol
gebraucht	second hand
Wohlbefinden	Well-being
dokumentieren	document
Verlogenheit	Mendacious
Abhängigkeit	Dependency
fehlerhaft	faulty
Hydraulik	Hydraulics
Lügendetektortest	Popular attector
Archäologe	archaeologist
Tupfer	swab
dazugehören	this includes
Alimente	alimony
Spange	Clasp
Nabel	navel
durchlöchern	perforate
weltlich	secular
Zypern	Cyprus
Angelrute	fishing rod
frühestens	at the earliest
Gefährdung	Danger
Kriterium	criteria
Mittelsmann	Medium
entsichern	release
Telefonrechnung	Telephone bill
Zeit schinden	Time shaping
Popmusik	pop music
mobilisieren	mobilize
mitfliegen	fly
Beatmung	Ventilation
Chorgesang	Choir
zutreffend	applicable
verbal	verbal
Aal	eel
Doktorarbeit	Doctoral thesis
Prellung	bruise
Geiselnahme	hostage taking
Sellerie	celery
Rockband	Rock band
Popularität	popularity
Erkrankung	illness
Druckwelle	Pressure wave
statistisch	statistical
Workshop	Workshop
Repräsentant	representative
Traumwelt	Dream world
Beschuss	bombardment
Spuk	Spooky
eisig	icy
Holzkopf	Wooden head
Mittagszeit	Lunchtime
einleben	settle
schwatzen	chatter
infolge	as a result
ausbaden	load
Schafott	scaffold
freudig	joyful
närrisch	foolish
Skizze	sketch
verschrecken	trim
annehmbar	acceptable
damalig	at that time
Bandage	bandage
schottisch	Scottish
Morgenrock	Morning skirt
verfliegen	decline
Riecher	nose
plausibel	plausible
Schlüsselloch	keyhole
Rattengift	Rug
Aufstand	revolt
besänftigen	soothe
Sauberkeit	cleanliness
existierend	existing
rekonstruieren	reconstruct
hierlassen	leave here
Grübchen	dimple
obenauf	on top
nichtsdestotrotz	Nevertheless
Kontaktmann	Contact man
wohingegen	whereas
Leuchtfeuer	beacon
Brandung	surf
Stickerei	embroidery
Anprobe	Sampling
schmollen	roll
Verwüstung	devastation
beschlagen	fog
Schluckauf	hiccup
Fasan	pheasant
vorbehalten	Reserved
Leitartikel	editorial
tuten	tute
ehemals	formerly
nachahmen	imitate
Busch	bush
beharrlich	persistent
Frachtraum	Cargo
hinwegkommen	come across
Knast	Jail
überrollen	roll over
Pore	pore
zusetzen	add
durchnässen	soak
Altstadt	Old town
untergraben	undermine
indirekt	indirectly
Wirbelsturm	Hurricane
Flutwelle	tidal wave
philosophisch	philosophical
Spielzug	Moving train
beschädigen	to damage
unentbehrlich	essential
herumliegen	lying around
ausfragen	inquire
monatlich	per month
akademisch	academic
Todsünde	mortal sin
schleusen	lock
Geisteskrankheit	Mental illness
Starthilfe	Jump
banal	banal
unnütz	useless
berauschen	enrapture
einfliegen	fly
erdrücken	crush
im Alleingang	single-handed
verleiten	lose
innig	intimate
Empfindung	sensation
Steckbrief	Characteristics
Schreiner	Carpenter
Gebell	barking
abtrocknen	dry
schikanieren	harass
empörend	outrageous
Projektor	projector
Gebrauchtwagen	used cars
angewidert	disgusted
Elfe	Elf
Gerüst	framework
verantwortungslos	irresponsible
bereichern	enrich
orientieren	orientate
bestücken	fit
tilgen	pay off
bedrängen	press
unzulässig	inadmissible
draufstehen	get on top
Tollpatsch	Rugged
Anbruch	Pitch
Flüchtlingslager	Refugee camp
neurotisch	neurotic
Schimpfwort	Scoldword
Expansion	expansion
Schlepper	tractor
Nachttisch	Bedside table
Termite	termite
Mündung	mouth
industriell	industrial
stubenrein	Potty trained
Gefängnisstrafe	Prison
kaltmachen	keep cold
platschen	splash
einnicken	doze off
Nachfahre	Downstream
empfänglich	susceptible
untätig	idle
Baseballspiel	Baseball game
Sensibilität	sensitivity
Sadist	sadist
reinwaschen	wash
Dissertation	dissertation
Prachtkerl	Splendid guy
Spaßvogel	Jewel
Lotion	lotion
Magister	Magister
Schießstand	Shooting range
Auspuff	Exhaust
Kruzifix	crucifix
Darsteller	actor
Gewaltanwendung	Violence
labil	labile
kastrieren	castrate
schlummern	slumber
Besorgung	Disposal
zusammenstellen	put together
klamm	gorge
beträchtlich	considerably
pathetisch	pathetic
zurückfallen	fall back
zerhacken	chop
Vermittler	Intermediary
einstweilig	injunction
Quartal	quarter
absprechen	arrange
ablesen	read off
Epilepsie	epilepsy
geladen	invited
Einweisung	Instruction
herrschend	ruling
drankriegen	drank
überbewerten	overvalue
nebenher	on the side
krabbeln	crawl
Vektor	vector
Raffinerie	refinery
Lederjacke	Leather jacket
mogeln	mug
Telefonleitung	Telephone line
Maschinengewehrfeu	Machine gun
Föhn	hairdryer
Müllabfuhr	Garbage
brandmarken	brand
Lügendetektor	lie detector
niederschießen	shoot down
Sägewerk	Sawmill
Tafelrunde	Tablet
Tiefgarage	underground car park
Privatschule	Private school
Amulett	amulet
Bruchlandung	Fracture
Interviewer	interviewer
Baumhaus	tree house
Aufkleber	sticker
Kontext	context
Schließung	closure
(he)rausfallen	(Hey) fall out
einmarschieren	parade
Gynäkologe	gynecologist
Fratze	Fret
beglücken	conflict
erröten	blush
rosig	rosy
trüb	mumble
Selbstbeherrschung	Self-control
Vertrauter	Familiar
stattlich	handsome
aussätzig	leprous
vorteilhaft	advantageous
aushecken	bleed
Flugfeld	Airfield
auffangen	catch
Export	export
diesseits	on this side
krönen	crown
verbarrikadieren	barricade
unverbesserlich	incorrigible
unerbittlich	relentless
Duplikat	duplicate
zeitlich	temporal
mitreißen	drag
Kurzform	short form
Gemüt	mind
unermüdlich	tirelessly
Treibsand	Tribal
Metzgerei	Butcher's shop
Derby	Derby
störrisch	stubborn
Mysterium	Mystery
schieflaufen	go wrong
Begleiter	companion
Schlüsselbein	Clavicle
Inventur	Inventory
Rammbock	battering ram
Boxkampf	Boxing
tolerant	tolerant
Skalp	scalp
begeben	issue
wunderhübsch	wonderful
Verrücktheit	Madness
reizbar	irritable
Scharfsinn	Awkward
abnutzen	wear
Herrenhaus	Mansion
Sägemehl	sawdust
Verlobungsring	Engagement ring
massenweise	mass
unschädlich	harmless
unterkommen	condemn
hervorbringen	bring forth
festmachen	moor
rinnen	gut
abfackeln	flare up
durchfahren	drive through
Inferno	inferno
Weiblichkeit	femininity
diktieren	dictate
verschwören	seize
Fusel	Fusel
berechenbar	predictable
unvergesslich	unforgettable
unbestimmt	indefinitely
übermäßig	excessive
Magenschmerz	Stomach pain
Notlage	Emergency
Weihnachtskarte	Christmas card
Generalprobe	Sample
schälen	peel
entern	enter
Osteuropa	Eastern Europe
Zopf	Braid
Koordination	coordination
Schönheitssalon	Beauty salon
Großpapa	Big papa
Ausbruch	outbreak
ausschlagen	knock out
regulär	regular
Imitation	imitation
beaufsichtigen	supervise
erhältlich	available
Zweitbesetzung	Second occupation
Porzellan	porcelain
Schwimmbecken	Swimming pool
einzahlen	deposit
reinfahren	drive in
Himmelreich	Heaven
Mädchenname	Maidename
bewähren	prove
hierin	here in
ausbluten	bleed out
Nerz	mink
Erwähnung	mention
Bräune	tan
Schnitzel	schnitzel
Banknote	Banknote
Pensionierung	retirement
zuschreiben	attribute
unbarmherzig	merciless
Oberfeldwebel	Oberfeldebel
leger	casual
Entfernung	distance
Befehlsgewalt	Command
Verteidigungslinie	Defense line
Steg	web
rupfen	pluck
Spektrum	spectrum
schnellstmöglich	as soon as possible
siebzig	seventy
erkennbar	recognizable
Plackerei	Plackey
wiederbeleben	revive
ausfressen	eat out
Eishockey	ice Hockey
unbehaglich	uncomfortable
nachschlagen	look up
Ammoniak	ammonia
unausweichlich	inevitable
Sprengsatz	Explosive
Einigkeit	unity
reproduzieren	reproduce
Zaubertrick	Magic trick
Samariter	Samaritan
interstellar	interstellar
Orientierung	orientation
Überlebenschance	Chance
entspannend	relaxing
Zins	interest
Rächer	avenger
unrealistisch	unrealistic
Sonderkommando	special command unit
unzerstörbar	indestructible
ausspionieren	spine
Gehweg	side walk
Gendarmerie	Gendarmerie
seitens	side
ausradieren	rub out
herkriegen	ride
disziplinieren	discipline
Tischler	carpenter
Personalabteilung	Personnel department
überrumpeln	override
riesengroß	huge
entspringen	arise from
schizophren	schizophrenic
auskosten	offer
Bankwesen	Banking
Gewehrschuss	Rifle
Sandsturm	Sandstorm
wundersam	miraculous
Wortschatz	vocabulary
abzüglich	less
unvermeidbar	unavoidable
zahm	tame
ergo	ergo
Kreuzfeuer	Crossfire
Mordversuch	Murder attempt
Wandschrank	Closet
Einzelkind	Single child
Verteilung	distribution
Auslieferung	delivery
Makkaroni	macaroni
Murmeltier	marmot
Namensschild	Name tag
absaugen	suck
Präfekt	prefect
blubbern	bubble
Haupttor	Main gate
knackig	crisp
kollektiv	collective
Ödland	wasteland
Trainingslager	Training camp
Meeresfrüchte	seafood
Stammkunde	Regular
Wiedervereinigung	reunion
Täufer	baptist
multipel	multiple
Fruchtblase	Fruit bubble
Ansturm	Rush
rüberbringen	bring over
Morgendämmerung	Dawn
genehm	approval
verschleiern	disguise
Einöde	Seed
Galeere	galley
Zwangsarbeit	Forced labor
benebeln	bleed
mühelos	effortlessly
Platin	platinum
Stierkampf	Bullfighting
Schweinestall	Pigsty
Bestattung	funeral
Dackel	dachshund
überschlagen	skim
seiden	silk
schlaflos	sleepless
Schiffbruch	Shipwreck
Schachspiel	Chess game
erdenklich	impressive
Lustmolch	Lustmolch
Fortschritt	progress
erhellen	brighten up
aufwischen	mop up
Kajüte	cabin
wohlbehalten	safe
Heide	pagan
Polka	polka
selbstlos	selfless
herausschneiden	cut out
navigieren	navigate
keusch	chaste
ausreiten	ride out
Lämmchen	Lamb
geraum	gel
wohltätig	charitable
hinauswerfen	throw out
Racker	Rascal
wehrlos	defenseless
liquidieren	liquidate
Wunderland	Wonderland
Augenfarbe	Eye color
begierig	eager
Geschehnis	event
Zauberkraft	Maggot
Arier	Arier
paddeln	paddle
angeboren	innate
minder	less
verhöhnen	mock
Aufrührer	rebel
übermütig	cocky
ungenau	inaccurate
fertigstellen	complete
Manifest	manifest
Wohltätigkeit	Charity
vorankommen	move forward
Fischerboot	Fishing boat
rüde	male
Kleinholz	Small wood
Brautpaar	Bridal
amtlich	official
einschnappen	snap
Notbremse	Emergency brake
Riesenfehler	Giant
Polster	pad
gegenübertreten	oppose
kennzeichnen	mark
meditieren	meditate
Gebräu	brew
appellieren	appeal
rausrutschen	slip out
Schwachsinn	Nonsense
verheerend	devastating
Badehaus	Bathhouse
Piste	piste
fürsorglich	careful
Redewendung	Phrase
vergänglich	transient
Schmiergeld	Lubrication
halbnackt	half-naked
Stabschef	chief of staff
bereisen	travel
Frevel	Frost
inhalieren	inhale
unorthodox	unorthodox
im Endeffekt	in the end
Patent	patent
Gesinnung	attitude
Mund	mouth
wühlen	dig
Punktzahl	score
regeln	regulate
Verb.	Verb.
ausspielen	play out
Tarantel	tarantula
offenkundig	obvious
vorherbestimmen	predict
liebkosen	caress
Statur	stature
Pseudonym	pseudonym
komischerweise	strange
Kostüm	costume
Entlein	duckling
strategisch	strategically
überdauern	outlive
Provinz	province
Privateigentum	Private property
nachprüfen	check
Larve	larva
beherbergen	harbor
abtauchen	dive
Benefizveranstaltung	Charity
prall	plump
Fleischfresser	Carnivore
legitim	legit
vertiefen	deepen
Signalton	Beep
unentdeckt	undetected
Sprengladung	Crackling
zweifelhaft	doubtful
verkohlen	char
Belang	Relevant
entheben	relieve
Wettervorhersage	Weather forecast
Gepäckträger	Luggage rack
duften	smell
Abreibung	Rubbing
hinken	limp
Befürchtung	apprehension
Herberge	hostel
Kaste	caste
Anomalie	anomaly
frühzeitig	early
ringsum	round
Obduktion	autopsy
Keuschheit	chastity
buddeln	dig
Kaffeemaschine	coffee machine
ausbeuten	exploit
Unterhändler	Negotiator
Paarung	pairing
Yak	yak
ausgleichen	compensate
Zündschnur	Cord
konform	compliant
Gesuch	Search
fortpflanzen	reproduce
anschalten	turn on
Armaturenbrett	dashboard
Bardame	barmaid
Haschisch	hashish
rühmen	praise
Elektrik	Electrics
taktisch	tactical
rapide	rapid
beurlauben	vacuum
maskieren	mask
Mätresse	mistress
Seifenoper	Soap opera
zudröhnen	swatch
Kondensator	capacitor
fortgeschritten	advanced
Rechtssystem	Legal system
Geschlechtskrankheit	Sexual disease
hinfliegen	fly
Augapfel	eyeball
verkorksen	cork
Verfolgungswahn	Persecution
Erdöl	oil
haarig	haired
im Nachhinein	in retrospect
Beschädigung	damage
hierherkommen	come here
Verbraucher	consumer
frigide	frigid
Ladendiebstahl	Shoplift
Münztelefon	payphone
Panther	Panther
Bauchspeicheldrüse	pancreas
Ideologie	ideology
(he)runterziehen	(Hey)
Urknall	Big Bang
Raster	Grid
Lümmel	lout
Geländewagen	Scroll
Belegschaft	Workforce
Zauberformel	Magical formula
Judentum	Judaism
Sterblichkeit	mortality
Weihnachtstag	Christmas Day
Ortung	Location
grünlich	greenish
fragil	fragile
Naturell	Nature
fortwährend	continual
necken	tease
Besuch	visit
verwerfen	discard
zusammenhängen	contour
Stadtrand	suburban
feurig	fiery
erkenntlich	detachable
Ansammlung	collection
heidnisch	pagan
Anstoß	kicking off
Enthüllung	revelation
Kollaps	collapse
unsinnig	nonsensical
präparieren	prepare
Menschenblut	Crude
nutzbar	usable
Versteckspiel	Hide and seek
leblos	lifeless
Diva	diva
Weibsbild	Fashion
Leopard	leopard
hurtig	whining
einfügen	insert
todmüde	fatigue
Humbug	humbug
wittern	wander
Admiralität	Admiralty
Inhaber	owner
Schläfchen	nap
Mittelamerika	Central America
bezwecken	purpose
frontal	frontal
bereitwillig	readily
Glücksfall	Stroke of luck
Schönling	Sweetheart
nachdenklich	pensive
Modenschau	Fashion show
Hauptgewinn	Privacy
jonglieren	juggle
bemerkbar	noticeable
grimmig	grim
umringen	surround
einlaufen	paved
Vorväter	Forefater
Beschuldigung	accusation
redlich	honest
unentwegt	undisguised
sehnsüchtig	yearning
dienstlich	official
Diplomatie	diplomacy
trügen	tries
Einfaltspinsel	Plumbing
Wundbrand	Woundbrand
Durchführung	execution
unterdessen	meanwhile
gegeben	given
Zwillingsschwester	twin sister
freundschaftlich	friendly
Sonntagnachmittag	Sunday afternoon
Schießerei	shoot-out
miterleben	persist
Signalhorn	Signal horn
farbenblind	color-blind
ritzen	scratch
Grauen	Gray
Ständchen	serenade
Gewinn	Profit
imponieren	impress
unverwundbar	invulnerable
Walross	walrus
durchkreuzen	cross
spürbar	noticeable
Titan	titanium
Warteliste	Waiting list
lebensgefährlich	dangerous
alltäglich	everyday
schlimmstenfalls	at the worst case
unweigerlich	inevitably
Fahrschein	Ticket
Verlierer	loser
Besserwisser	Know-it-all
dinieren	dance
Geständnis	confession
Mietvertrag	rental contract
liieren	lign
reingeraten	revering
entreißen	snatch
Warenhaus	Store
Unterschlagung	embezzlement
zurücklehnen	lean back
Ungewissheit	uncertainty
herausgeben	issue
exquisit	exquisite
tschechisch	Czech
geräumig	spacious
fünftausend	fivethousand
Autoreifen	car tire
einschreiten	intervene
ehelichen	marital
Rapport	rapport
Dirigent	conductor
gurgeln	gargle
Hülse	Sleeve
Rotznase	Snot
Vorschau	preview
herablassend	condescending
unterstreichen	underline
ausquetschen	squeeze
unwiderruflich	irrevocable
Übermacht	Superior
Preisgeld	Prize money
hinschauen	look
Krippe	crib
Läuterung	purification
Kriegsgefangener	Prisoner
hinterfragen	questioning
Einlieferung	Delivery
Gönner	patron
einkreisen	circle
verletzend	hurtful
dichtmachen	seal
wirbeln	swirl
Abschleppwagen	Towing
rebellieren	to rebel
Fehltritt	Mistake
Beschaffenheit	nature
Ausflug	Excursion
fossil	fossil
rosarot	pink
transferieren	transfer
Kilogramm	kilogram
Beinarbeit	Leg work
unbestreitbar	indisputable
abschrecken	scare off
durchstellen	go through
Südosten	southeast
zuordnen	assign
Förderung	advancement
ruhmreich	glorious
umfahren	drive around
verdunkeln	darken
wegräumen	clear away
verkrüppeln	cripple
mörderisch	murderous
einsacken	bare
Schwerelosigkeit	weightlessness
Exkursion	field trip
pingelig	picky
Luftröhre	windpipe
Kaffeepause	coffe break
potentiell	potentially
unschön	unsightly
bekriegen	weapons
gutheißen	well
todkrank	ill
Unterleib	Abdomen
Äußerung	Utterance
enttarnen	unsteady
seelisch	mental
freikaufen	free
hochmütig	haughty
Feierlichkeit	solemnity
einbrennen	burn up
leichtgläubig	gullible
chronisch	chronic
Entzündung	inflammation
Ritus	rite
Anus	anus
festsetzen	set
Handel	trade
organisiert	organized
Völkermord	genocide
Grünzeug	Greens
Vlies	fleece
Einberufung	Convening
Muttersprache	mother tongue
niederstrecken	lay down
sozialistisch	socialist
Torwart	goalkeeper
Bearbeitung	Editing
Edelstein	Gemstone
abrupt	abruptly
minimal	minimal
Schlüsselbund	Keychain
Parzelle	plot
brauchbar	useful
benützen	use
gesetzlos	lawless
Konsum	consumption
Basislager	Base camp
glasklar	crystal
Familienleben	Family life
vergasen	gas
nonstop	nonstop
elektromagnetisch	electromagnetic
überreagieren	overreact
Rugby	rugby
Anwaltskanzlei	law firm
Kabeljau	cod
Schotter	gravel
dealen	disease
Abführmittel	laxative
Schamhaar	Pubic hair
Drogenbehörde	Drug authority
urinieren	urinate
terroristisch	terrorist
Näherin	seamstress
Profikiller	Professionalist
Komponente	component
stocksauer	skewer
Lieblingsfilm	favourite movie
Informationsbeschaffung	information gathering
Kinderarzt	Pediatrician
Koalition	coalition
Zwillingsbruder	twin brother
Sudan	Sudan
Infusion	infusion
niederknien	kneel down
gehoben	lifted
anzweifeln	doubt
Rekonstruktion	reconstruction
Dichter	poet
Mitspieler	Player
baumeln	dangle
Beschleunigung	acceleration
abgewöhnen	break the habit
zanken	caution
ergründen	fathom
tragbar	portable
Teufelskreis	Vicious circle
verschnaufen	catch
unbewohnt	uninhabited
Fragerei	Questioning
Anziehung	attraction
Schaukelstuhl	Rocking chair
Einschränkung	Restriction
Zirkel	Circle
Schlafplatz	Sleeping place
gedankenlos	thoughtless
Spiegelei	fried egg
neblig	foggy
beglückwünschen	congratulate
kapern	capture
Mentalität	mentality
stetig	steady
lachhaft	laughable
Handarbeit	Handwork
Polizeipräsidium	Police headquarters
eintreiben	set
gebührend	due
Vollendung	completion
Liebesnest	Love nest
Stall	barn
Gedeck	Setting
seinesgleichen	unique
Hausbesuch	Home visit
nachforschen	inquire
signalisieren	signal
Pionier	pioneer
weiterschlafen	sleep on
verdenken	blame
vorbringen	mention
telegrafieren	telegraph
Weinberg	Vineyard
Taschendieb	Picker
Spatzenhirn	Sparrow brain
auftauen	thawing
zurücksetzen	reset to default
Fehde	feud
Göttlichkeit	divinity
unattraktiv	unattractive
Unzufriedenheit	discontent
zurückführen	bring back
umbauen	rebuild
Pfefferminz	peppermint
rasseln	rattle
einbeziehen	include
Spähtrupp	Scout
neugeboren	newborn
kursieren	circulate
spießig	spit
sonstwo	otherwise
Zubehör	equipment
anzetteln	put on
Korkenzieher	corkscrew
herausreißen	tear out
Versand	shipping
boshaft	malicious
erträglich	bearable
betrauen	entrust
antreffen	meet
Schwiegereltern	In-laws
ehrwürdig	venerable
vordringen	penetrate
seelenverwandt	soul-related
Schienbein	Shin
Mordopfer	Murder
frühmorgens	early in the morning
Gehsteig	pavement
nahrhaft	nutritious
weiterkommen	go on
zerschießen	shoot up
diplomatisch	diplomatic
durchgeben	enlarge
beschränkt	limited
Wohlfühlen	Feel good
einräumen	grant
Konsument	consumer
würzen	Spice up
Veruntreuung	embezzlement
ruhelos	restless
rastlos	restless
montieren	mount
Gedränge	hustle
vermögend	wealthy
Faszination	fascination
Palais	Palais
wohnhaft	resident
zugegen	present
separat	separately
aufspielen	play
Halbfinale	Semifinals
Schürzenjäger	Jaw
Sehenswürdigkeit	Sightseeing
Puma	puma
Schilf	reed
Gurgel	throat
Beseitigung	Elimination
materiell	material
eingraben	dig up
Sternenstaub	Stardust
Geschlechtsumwandlung	gender transformation
prahlen	brag
Kirmes	Fair
bekanntlich	known
Konditorei	Pastry
Ecuador	Ecuador
gastfreundlich	hospitable
verlagern	relocate
umschauen	look around
Luftschacht	Shaft
Steuergeld	Tax rate
behaart	hairy
Backofen	oven
kampflos	fearlessly
Drillinge	triplets
tiefgründig	profound
Cabaret	Cabaret
rehabilitieren	rehabilitate
Gebrauchsanweisung	Instructions for use
Diakon	deacon
hochachtungsvoll	Sincerely
individuell	individually
Stachelschwein	Porcupine
einfahren	retract
anfeuern	cheer
Teamarbeit	Teamwork
allzeit	all time
Solidarität	solidarity
Australier	Australian
Schlagstock	Punch
Parodie	parody
schlussendlich	Finally
Wiederauferstehung	Resurrection
Stoßstange	bumper
dekorieren	decorate
Schaltkreis	Circuit
Sicherheitsrisiko	Security risk
Allgemeinheit	Publicity
Geheul	howling
heilend	healing
Düse	jet
abtrünnig	renegade
anschleichen	loosen
Fluch	curse
Waffenbesitz	Weapon
schmackhaft	tasty
Kontrolleur	controller
Apfelsaft	Apple juice
quittieren	quit
Plastiksprengstoff	Plastic explosive
auftanken	refuel
Kniescheibe	Kneecap
weitersagen	wonder
Stabilisator	stabilizer
Wehrdienst	Military service
vital	vital
Punktestand	Score
Stundenkilometer	Hour kilometer
Melder	Detector
Südseite	Side
schmerzvoll	painful
Kühlraum	Refrigerator
städtisch	urban
Kalbfleisch	veal
Programmierung	programming
Festival	festival
ironischerweise	Ironically
Dialyse	dialysis
etablieren	establish
Baustein	Building block
absolvieren	graduate
psychotisch	psychotic
Kommune	Municipality
defensiv	defensive
Kosmetikerin	beautician
Vorschule	Preschool
Hepatitis	hepatitis
Stöckchen	stick
Sprengkörper	Explosive
im Uhrzeigersinn	clockwise
eingrenzen	enclose
Fitnessstudio	Gym
Rumänien	Romania
belgisch	Belgian
Schneeball	Snowball
beschmieren	grape
zurückweichen	go back
schlechthin	unless
unüblich	unusual
stemmen	to stem
scheuen	shy away
würdigen	honor
vergönnen	clip
einfältig	imaginable
vergöttern	idolize
Fiedler	fiddler
Kirchturm	Church tower
Deck	deck
Erhalt	Receipt
Promotion	promotion
Großmama	Grandmother
Verwesung	decay
Weinbrand	Brandy
österreichisch	Austrian
mitgeben	give
vollzählig	fully
ruhen	rest
vollpumpen	full pump
versprechend	promising
heiser	hoarse
veralbern	scald
Debüt	debut
transparent	transparent
Erweiterung	extension
Hausnummer	House number
Taschenmesser	pocket knife
fraglich	questionable
Ausfall	failure
festigen	consolidate
Affentheater	Monkey theater
schutzlos	glorious
Specht	woodpecker
steril	sterile
anregen	stimulate
sonstwas	anything else
unbeholfen	awkward
beschwipst	tipsy
zuvorkommen	attend
voraussichtlich	expected
Muskelkraft	Muscle
Privatsache	Privacy
häuslich	domesticated
Abschiedsparty	Farewell party
Sakrileg	sacrilege
pflügen	plow
Versteigerung	auction
aufsammeln	collect
zufriedenstellend	satisfactory
durchbringen	put through
Geschichtsbuch	History book
Umleitung	detour
dementsprechend	accordingly
Redefreiheit	Freedom of speech
Gesichtszug	Face
mittelalterlich	medieval
Ghetto	ghetto
einplanen	plan on
rausrücken	move out
Nektar	nectar
wedeln	wag
Pförtnerhaus	Lorry
Fügung	Joint
Faulheit	idleness
überschreiben	override
Klebstoff	adhesive
anlaufen	start
schleimig	slimy
Beduine	Bedouin
hernehmen	go
Zobel	sable
Glückstreffer	lucky Strike
Drogerie	Drugstore
Bergung	Salvage
verstauen	stow
Gleichstand	a draw
Gegenseite	Opposite
mittelmäßig	mediocre
Lavendel	lavender
treffend	apt
bedürftig	needy
vergriffen	outright
unterjubeln	go under
Zweitschlüssel	Slouses
anstößig	offensive
voreinander	in front of each other
Inventar	inventory
lehrreich	instructive
Aufschrift	inscription
Übernachtung	overnight stay
bedeutsam	significant
unüberlegt	uncertain
unsympathisch	unsympathetic
prompt	prompt
Feststellung	Statement
Naivität	greenness
zweitbeste	second best
seinerzeit	at that time
Areal	Areal
holländisch	Dutch
Ziel	aim
Verbeugung	bow
hieraus	from this
Etui	case
bewerkstelligen	accomplish
Oberkellner	Top waiter
schwarzweiß	black-and-white
zahllos	countless
Portwein	port wine
zumuten	enlarge
todernst	tooth
Bibliothek	Library
unglaubwürdig	unbelievable
Anlegestelle	Jetty
gurren	coo
Ostfront	Ostfront
Bombardement	bombardment
Sonett	So nice
impfen	vaccinate
Eisbär	Icebear
dahinterstecken	go behind
recken	stretch
hinhauen	hound
Schulbus	School bus
auserkoren	chat
Wettstreit	Betting
vermählen	bolt
kaputtgehen	break down
Verstand	understanding
Präsidentschaft	Presidency
reizvoll	charming
Heiland	Saviour
Hanswurst	Hanswurst
Öffentlichkeitsarbeit	public relation
Erotik	eroticism
verminen	mine
Erdoberfläche	Earth surface
erblinden	blind
Vöglein	little bird
Schnauzbart	Snooze
zerfressen	eat away
abraten	be advised against
Vermerk	Note
anlehnen	lean on
Rückruf	recall
inständig	intended
verfrüht	premature
Magnetfeld	Magnetic field
fertigen	produce
Ausrottung	extermination
kontrovers	controversial
plastisch	plastic
durchgeknallt	crowned
Bedenkzeit	time to think
allergrößte	greatest
anstreben	strive for
Kundgebung	rally
beige	beige
Telefongespräch	Telephone conversation
jiddisch	Yiddish
Entwarnung	All-clear
perfektionieren	perfect
herausnehmen	remove
Abweichung	deviation
auswechseln	replace
Gegenseitigkeit	reciprocity
Glückszahl	lucky number
Terminplan	Schedule
Rasierwasser	aftershave
Markenzeichen	Trademark
störend	disturbing
reinpassen	fit in
unzurechnungsfähig	uninformable
Innenseite	inside
vergelten	retard
hochhalten	hold up
verrenken	crook
Knopfdruck	Push
Gelee	jelly
hingucken	sweep
unbeliebt	unpopular
Tonbandgerät	Tape
Abschrift	copy
abrücken	move
zahlenmäßig	numerical
klatschnass	wet
schaben	scrape
gruppieren	group
siebenmal	seven times
implantieren	implant
Verlegung	laying
bemannen	man
Einsatzkommando	Commander
verräterisch	treacherous
injizieren	inject
Töpfchen	potty
unerfreulich	unpleasant
geheuer	safety
anlocken	attract
Funkverbindung	Radio connection
greifbar	tangible
Reim	rhyme
Ausweichmanöver	Evasive maneuver
Gesundheitsbehörde	Health authority
Bahnstation	Train station
absägen	saw off
variabel	variable
Pressesprecher	Spokesman
Lichtjahr	Light year
schnaufen	twist
Gemütlichkeit	Coziness
infrarot	infrared
Kassettenrekorder	Cassette recorder
Werwolf	werewolf
Kurator	curator
Beschwörung	incantation
Empfangsdame	Receptionist
ungeniert	unacceptable
Omama	Omama
Wiederaufbau	reconstruction
umleiten	redirect
Renovierung	renovation
Fertigstellung	completion
traumatisch	traumatic
anspringen	start an engine
knirschen	crunch
Schusswechsel	Shot change
Treibhauseffekt	Greenhouse effect
anreisen	arrive
Administration	administration
Schwerverbrecher	Heavy criminal
anvisieren	dance
Talkshow	Talk show
Normalität	normality
Prothese	prosthesis
Navigationssystem	navigation system
Räumung	eviction
Simulator	simulator
Opossum	possum
verfüttern	fiddle
Holzschnitt	Woodcut
Quellcode	Source code
Tippfehler	Typing error
vorsichtshalber	precautionary
oral	orally
Personalakte	Personal file
Wortlaut	text
fassungslos	stunned
tückisch	treacherous
eigens	specially
entfesseln	unleash
Patenkind	Godchild
ungesetzlich	unlawful
Überraschungsangriff	Surprise attack
Orgie	orgy
Krawall	Crawl
umsichtig	prudently
aufhetzen	put on
Bekanntmachung	Notice
Komposition	composition
boykottieren	boycott
Sonderausgabe	Special edition
Abendschule	Evening school
hinschmeißen	chuck down
Schlummertrunk	Slumber
Anarchist	anarchist
Möhre	carrot
herfallen	fall
Begebenheit	Passage
zerstreiten	break
protzig	pretentious
Geschicklichkeit	skill
ansatzweise	rugged
Unwesen	Unsound
Salto	Salto
Hungerstreik	Hunger strike
triumphieren	triumph
Ringkampf	Ring fight
fungieren	act
Überhand	Overhand
optimal	optimal
Autorennen	motor race
zutreffen	hold true
guttun	do well
Geologie	geology
abstechen	scan
tagaus	day out
einstudieren	rehearse
ausscheiden	leaving
Kennwort	password
vertrocknen	dries out
Anstandsdame	Decency
duellieren	duel
Grabräuber	Grave robbers
um meinetwillen	To meet me
Jurist	jurist
tagein	day a
Resolution	resolution
andauern	last for
Kommentator	commentator
Vergiftung	poisoning
Bewässerung	irrigation
überbieten	overbid
aushändigen	hand out
ordnungsgemäß	properly
Geizkragen	Agitator
zerspringen	croup
Geheimgang	Shell
Sonnenstich	Sunbeam
Sterbebett	Deathbed
Verzicht	Waiver
versengen	scorch
glaubhaft	credible
entmutigen	discourage
mittelgroß	medium-sized
Schnupftabak	snuff
überanstrengen	overstrain
knipsen	snap
anlässlich	on the occasion
Seelenfrieden	Peaceful peace
indianisch	Indian
expandieren	expand
stimulieren	stimulate
Plakette	plaque
draufsetzen	sit on
abweisend	dismissively
Viertelmillion	Quarter million
Polyp	polyp
Dozent	Lecturer
hinterlegen	deposit
starrköpfig	rigid
anreden	address
ausstechen	cut out
mitsingen	sing along
ausdrucken	print
trunken	drunk
Bußgeld	fine
polizeilich	police
nordwärts	north
Einzelteil	Item
Flieder	lilac
chic	chic
Bezirksstaatsanwalt	District prosecutor
Blutzucker	Blood sugar
publik	public
schmierig	greasy
umliegend	surrounding
Inserat	Ad
drumherum	around
Springbrunnen	fountain
Sonntagabend	Sunday evening
Halsabschneider	Neck cutter
einseitig	unilateral
erfrischen	refresh
unaufhaltsam	unstoppable
nächtelang	night
Streiterei	Quarrel
entsenden	send
Fechter	fencer
Guinea	Guinea
ungeahnt	unimagined
nörgeln	nag
manövrieren	maneuver
überhören	Ignore
sechseinhalb	six and a half
Warnschuss	Warning shot
Frauenarzt	Gynecologist
Schmeichelei	flattery
Raupe	Caterpillar
atmosphärisch	atmospheric
erblühen	bloom
Katakombe	catacomb
Schlittschuh	Skating
Pulle	Pulley
Denkzettel	Plot
Observatorium	observatory
Briefkasten	Mailbox
Filou	Filou
auschecken	check out
obschon	although
Kontostand	Bank balance
Gänseblümchen	daisy
bemalen	paint
Königsfamilie	Royal family
forschen	to research
einreiben	rub
Vitrine	Showcase
gefühlvoll	emotional
konvertieren	convert
abstrakt	abstract
trauernd	grief
Zurückweisung	Rejection
beharren	insistence
Überschwemmung	flooding
Rollfeld	Rollfield
erschallen	shuffle
Gleichberechtigung	equal rights
Zaubertrank	Potion
krankhaft	morbid
zusammenfassen	sum up
anschneiden	cut
Widerstand	resistance
rechtschaffen	righteous
Stätte	site
Kalzium	calcium
Wäschekorb	laundry basket
sterilisieren	sterilize
Kloster	monastery
Bundesregierung	Federal government
Umbau	modification
anfreunden	make friends
weitgehend	largely
ausblasen	blow out
Verbundenheit	Bond
Sprechstunde	Consultation
Zimmergenosse	Carpenter
Tulpe	tulip
Wiedergutmachung	Redress
plätschern	lapping
einordnen	rank
republikanisch	republican
Bestrahlung	Irradiation
Verkaufszahl	Sales number
verknüpfen	link
bildlich	pictorial
unumgänglich	uncomfortable
Sicherheitskraft	Security force
rösten	roast
Blazer	blazer
Schatz	sweetheart
hochfahren	go up
Verschwiegenheit	secrecy
Vorherrschaft	supremacy
Sonderbehandlung	Special treatment
Spontaneität	spontaneity
matschig	muddy
Kompetenz	competence
unersetzlich	irreplaceable
infiltrieren	infiltrate
Diener	servant
verständlicherweise	understandably
verdampfen	evaporate
Herrscher	Ruler
Umdrehung	revolution
unerkannt	unrecognized
Grimasse	grimace
robust	robust
Transit	transit
donnernd	thunderous
Projektion	projection
mimen	mimen
xxx.	XXX.
Sicherheitsbeamter	security guard
Hauptkommissar	Principal
zwinkern	to wink
sinnlich	sensual
spreizen	spread
Armenhaus	Poor house
Sicherheitsstufe	security_level
Tischgebet	Table prayer
Veranlagung	Predisposition
aufspießen	split
zurückfliegen	fly back
Schwachpunkt	Weak point
Luftverschmutzung	Air pollution
Verschmutzung	pollution
Drachen	Dragon
Kult	cult
vorab	in advance
Gremium	Committee
Sonnencreme	suncream
halbieren	halve
Vergünstigung	Privilege
Ökonomie	Economy
verschiffen	ship
feuerbereit	fizzling
befruchten	fertilize
verklingen	drain
Urinprobe	Urine
Gravitation	Gravitation
übersinnlich	supernatural
Verschlüsselung	Encryption
zuhalten	to keep
Möchtegern	Wannen
Rotation	rotation
okkult	occult
Kinderschänder	Child moles
Geldwäsche	Money laundering
holprig	bumpy
Ausgrabung	excavation
Privatisierung	privatization
Lebensqualität	life quality
Gehaltsliste	Salary list
Personenschutz	Personal protection
islamisch	Islamic
Klausur	Exam
Laichzeit	Spoat time
ausgestoßen	pushed out
Bombenangriff	Bombing
Stress	stress
ihresgleichen	unknown
zumeist	mostly
deinesgleichen	desir
erahnen	tape
vorladen	preload
Geschäftsleitung	Management
Unternehmung	Enterprise
sezieren	dissect
einwerfen	put in
Bescherung	handing out Christmas Presents
Wanderung	Hike
schwerlich	heavy
fabrizieren	fabricate
bezichtigen	accuse
hinauszögern	delay
Wertpapier	Security
Chloroform	chloroform
ulkig	funny
bewirten	host
vortrefflich	excellent
Dämpfer	mute
ausbezahlen	pay out
vorwarnen	warn
Nominierung	nomination
Pomade	pomade
Standesamt	Registry office
brodeln	boom
zerknittern	crumple
Campingplatz	campsite
Hosenträger	Bracket
Riesenspaß	Giant fun
verstreichen	elapse
gewahrt	preserved
Keil	wedge
anlächeln	smile
Anlauf	Start
tröstlich	comforting
rostig	rusty
Warterei	Waiting
entgleisen	derail
Bekanntgabe	Announcement
reflektieren	reflect
Westentasche	West pocket
schlüssig	conclusively
Bienenstock	Hive
aufzählen	enumerate
Trinkgeld	Tip
zubringen	bring to
Hintertreppe	Rear staircase
Ouvertüre	overture
Vergeudung	Waste
Kochtopf	cooking pot
traurigerweise	sad
Scharade	charade
nagen	gnaw
erstehen	buy
Lehrerzimmer	Teacher's room
wegsehen	look away
Seitenstraße	Side street
Tanzsaal	Dance hall
Rindvieh	cattle
Pergament	parchment
rüsten	upgrade
Schmalz	lard
unnahbar	unapproachable
Brennholz	firewood
Meeresspiegel	Sea level
Makrele	mackerel
skandalös	scandalous
Sparbuch	Savings
Häufchen	Heap
Geheimniskrämerei	Mystery
vorbildlich	exemplary
erwirken	obtain
Kutte	habit
Wachablösung	Watch removal
kampfbereit	fighting
ausborgen	borrow
Warze	wart
zerfleischen	ruffle
Rubin	ruby
stutzen	support
zunähen	to sew
zurückwerfen	throw back
Tritt	Joined
zurechnungsfähig	compatible
Rettungsring	Rescue ring
alleinstehend	single
Formsache	Shape
verwelken	wilt
Arztrechnung	Pharmaceutical
herausputzen	brush up
übertönen	overtones
Geheimwaffe	Secret weapon
Sohle	sole
sorgsam	carefully
Altersunterschied	age difference
verrosten	rust
Weigerung	refusal
Oase	oasis
Schaltung	circuit
verharren	remain
Schwan	swan
Idealist	Idealist
Gefrierschrank	freezer
unterlaufen	undergo
hitzig	heated
bedauernswert	mournful
streitig	dispute
mütterlich	maternal
zittrig	shaky
Rückschlag	Setback
verausgaben	expenses
nichtsnutzig	inexpressive
anfallen	attack
Eber	boar
stündlich	hourly
besudeln	belly
Widersacher	Adversary
Schüchternheit	shyness
seitwärts	sideways